,Province,Year,Age,Total,Male,Female
0,Whole country,2012,Total,12032798,7047944,4984854
1,Whole country,2012,Under 30 years,282910,156530,126380
2,Whole country,2012,30-39 Years old,1941927,1123901,818026
3,Whole country,2012,40-49 Years old,3108057,1771633,1336424
4,Whole country,2012,50-59 Years old,3090353,1799567,1290786
5,Whole country,2012,60-69 Years old,1913052,1139882,773170
6,Whole country,2012,70-79 Years old,1156929,676314,480615
7,Whole country,2012,80 years and over,264280,147203,117077
8,Whole country,2012,dead,275290,232914,42376
9,Whole country,2013,Total,12398627,7205138,5193489
10,Whole country,2013,Under 30 years,252730,140344,112386
11,Whole country,2013,30-39 Years old,1876828,1088176,788652
12,Whole country,2013,40-49 Years old,3166585,1783058,1383527
13,Whole country,2013,50-59 Years old,3235769,1859636,1376133
14,Whole country,2013,60-69 Years old,2006125,1183435,822690
15,Whole country,2013,70-79 Years old,1259948,732289,527659
16,Whole country,2013,80 years and over,308122,170351,137771
17,Whole country,2013,dead,292520,247849,44671
18,Whole country,2014,Total,12650446,7281977,5368469
19,Whole country,2014,Under 30 years,240293,134155,106138
20,Whole country,2014,30-39 Years old,1841226,1073637,767589
21,Whole country,2014,40-49 Years old,3231720,1801109,1430611
22,Whole country,2014,50-59 Years old,3302097,1864412,1437685
23,Whole country,2014,60-69 Years old,2089927,1218026,871901
24,Whole country,2014,70-79 Years old,1303758,749007,554751
25,Whole country,2014,80 years and over,325782,173816,151966
26,Whole country,2014,dead,315643,267815,47828
27,Whole country,2015,Total,13044592,7420711,5623881
28,Whole country,2015,Under 30 years,275103,152291,122812
29,Whole country,2015,30-39 Years old,1855775,1088849,766926
30,Whole country,2015,40-49 Years old,3280918,1811469,1469449
31,Whole country,2015,50-59 Years old,3376615,1869816,1506799
32,Whole country,2015,60-69 Years old,2243668,1285274,958394
33,Whole country,2015,70-79 Years old,1337172,759308,577864
34,Whole country,2015,80 years and over,366776,193279,173497
35,Whole country,2015,dead,308565,260425,48140
36,Whole country,2016,Total,13311319,7509980,5801339
37,Whole country,2016,Under 30 years,252840,140309,112531
38,Whole country,2016,30-39 Years old,1831033,1080179,750854
39,Whole country,2016,40-49 Years old,3291308,1805209,1486099
40,Whole country,2016,50-59 Years old,3439685,1876111,1563574
41,Whole country,2016,60-69 Years old,2383245,1344462,1038783
42,Whole country,2016,70-79 Years old,1375881,773971,601910
43,Whole country,2016,80 years and over,415544,218645,196899
44,Whole country,2016,dead,321783,271094,50689
45,Whole country,2017,Total,13669851,7666849,6003002
46,Whole country,2017,Under 30 years,252676,140360,112316
47,Whole country,2017,30-39 Years old,1805119,1069615,735504
48,Whole country,2017,40-49 Years old,3316590,1819578,1497012
49,Whole country,2017,50-59 Years old,3502715,1884236,1618479
50,Whole country,2017,60-69 Years old,2516893,1405068,1111825
51,Whole country,2017,70-79 Years old,1473092,822892,650200
52,Whole country,2017,80 years and over,473021,248717,224304
53,Whole country,2017,dead,329745,276383,53362
54,Whole country,2018,Total,14010290,7796112,6214178
55,Whole country,2018,Under 30 years,257292,142123,115169
56,Whole country,2018,30-39 Years old,1801650,1068892,732758
57,Whole country,2018,40-49 Years old,3309561,1819350,1490211
58,Whole country,2018,50-59 Years old,3600518,1908829,1691689
59,Whole country,2018,60-69 Years old,2640555,1453325,1187230
60,Whole country,2018,70-79 Years old,1541530,852061,689469
61,Whole country,2018,80 years and over,535334,283637,251697
62,Whole country,2018,dead,323850,267895,55955
63,Whole country,2019,Total,14335723,7922076,6413647
64,Whole country,2019,Under 30 years,250362,137260,113102
65,Whole country,2019,30-39 Years old,1741549,1033528,708021
66,Whole country,2019,40-49 Years old,3316628,1831187,1485441
67,Whole country,2019,50-59 Years old,3689400,1936430,1752970
68,Whole country,2019,60-69 Years old,2799643,1518678,1280965
69,Whole country,2019,70-79 Years old,1612620,881862,730758
70,Whole country,2019,80 years and over,598223,313984,284239
71,Whole country,2019,dead,327298,269147,58151
72,Whole country,2020,Total,14696617,8055345,6641272
73,Whole country,2020,Under 30 years,265312,144581,120731
74,Whole country,2020,30-39 Years old,1680384,993113,687271
75,Whole country,2020,40-49 Years old,3337805,1848890,1488915
76,Whole country,2020,50-59 Years old,3735459,1944969,1790490
77,Whole country,2020,60-69 Years old,3011572,1606968,1404604
78,Whole country,2020,70-79 Years old,1680030,908455,771575
79,Whole country,2020,80 years and over,658604,340544,318060
80,Whole country,2020,dead,327451,267825,59626
81,Whole country,2021,Total,15089160,8205832,6883328
82,Whole country,2021,Under 30 years,291496,158053,133443
83,Whole country,2021,30-39 Years old,1646737,966521,680216
84,Whole country,2021,40-49 Years old,3335444,1857714,1477730
85,Whole country,2021,50-59 Years old,3793303,1964907,1828396
86,Whole country,2021,60-69 Years old,3256053,1710826,1545227
87,Whole country,2021,70-79 Years old,1722827,919664,803163
88,Whole country,2021,80 years and over,723771,369045,354726
89,Whole country,2021,dead,319529,259102,60427
90,Whole country,2022,Total,15309392,8280854,7028538
91,Whole country,2022,Under 30 years,274062,147709,126353
92,Whole country,2022,30-39 Years old,1541372,900822,640550
93,Whole country,2022,40-49 Years old,3324304,1862073,1462231
94,Whole country,2022,50-59 Years old,3851520,1992505,1859015
95,Whole country,2022,60-69 Years old,3386411,1761125,1625286
96,Whole country,2022,70-79 Years old,1794585,947437,847148
97,Whole country,2022,80 years and over,808358,406519,401839
98,Whole country,2022,dead,328780,262664,66116
99,Whole country,2023,Total,15618261,8408927,7209334
100,Whole country,2023,Under 30 years,251544,135381,116163
101,Whole country,2023,30-39 Years old,1479689,862849,616840
102,Whole country,2023,40-49 Years old,3305362,1866321,1439041
103,Whole country,2023,50-59 Years old,3938164,2034884,1903280
104,Whole country,2023,60-69 Years old,3553549,1833085,1720464
105,Whole country,2023,70-79 Years old,1880330,981261,899069
106,Whole country,2023,80 years and over,879875,434080,445795
107,Whole country,2023,dead,329748,261066,68682
108,Seoul,2012,Total,2286639,1279363,1007276
109,Seoul,2012,Under 30 years,56359,29962,26397
110,Seoul,2012,30-39 Years old,373082,208947,164135
111,Seoul,2012,40-49 Years old,572673,315961,256712
112,Seoul,2012,50-59 Years old,600690,330606,270084
113,Seoul,2012,60-69 Years old,403231,233455,169776
114,Seoul,2012,70-79 Years old,215806,123630,92176
115,Seoul,2012,80 years and over,45835,22829,23006
116,Seoul,2012,dead,18963,13973,4990
117,Seoul,2013,Total,2306750,1280274,1026476
118,Seoul,2013,Under 30 years,48686,25746,22940
119,Seoul,2013,30-39 Years old,349106,194964,154142
120,Seoul,2013,40-49 Years old,577806,315927,261879
121,Seoul,2013,50-59 Years old,610404,331905,278499
122,Seoul,2013,60-69 Years old,414937,237187,177750
123,Seoul,2013,70-79 Years old,234031,134136,99895
124,Seoul,2013,80 years and over,52273,26041,26232
125,Seoul,2013,dead,19507,14368,5139
126,Seoul,2014,Total,2343420,1288868,1054552
127,Seoul,2014,Under 30 years,44964,23712,21252
128,Seoul,2014,30-39 Years old,334215,186613,147602
129,Seoul,2014,40-49 Years old,586890,318378,268512
130,Seoul,2014,50-59 Years old,617810,330607,287203
131,Seoul,2014,60-69 Years old,432347,243880,188467
132,Seoul,2014,70-79 Years old,249074,141849,107225
133,Seoul,2014,80 years and over,57687,28773,28914
134,Seoul,2014,dead,20433,15056,5377
135,Seoul,2015,Total,2386284,1297000,1089284
136,Seoul,2015,Under 30 years,48876,25421,23455
137,Seoul,2015,30-39 Years old,329574,184080,145494
138,Seoul,2015,40-49 Years old,588654,315886,272768
139,Seoul,2015,50-59 Years old,615893,323461,292432
140,Seoul,2015,60-69 Years old,456428,252657,203771
141,Seoul,2015,70-79 Years old,260688,147577,113111
142,Seoul,2015,80 years and over,65969,33125,32844
143,Seoul,2015,dead,20202,14793,5409
144,Seoul,2016,Total,2412355,1296509,1115846
145,Seoul,2016,Under 30 years,46637,24211,22426
146,Seoul,2016,30-39 Years old,324762,181221,143541
147,Seoul,2016,40-49 Years old,589865,313431,276434
148,Seoul,2016,50-59 Years old,614204,317841,296363
149,Seoul,2016,60-69 Years old,473306,257146,216160
150,Seoul,2016,70-79 Years old,269801,150743,119058
151,Seoul,2016,80 years and over,73479,37051,36428
152,Seoul,2016,dead,20301,14865,5436
153,Seoul,2017,Total,2436182,1295024,1141158
154,Seoul,2017,Under 30 years,47814,24615,23199
155,Seoul,2017,30-39 Years old,321360,178526,142834
156,Seoul,2017,40-49 Years old,587296,310785,276511
157,Seoul,2017,50-59 Years old,609218,310258,298960
158,Seoul,2017,60-69 Years old,483441,258073,225368
159,Seoul,2017,70-79 Years old,284739,156554,128185
160,Seoul,2017,80 years and over,81899,41410,40489
161,Seoul,2017,dead,20415,14803,5612
162,Seoul,2018,Total,2459986,1295775,1164211
163,Seoul,2018,Under 30 years,48966,25008,23958
164,Seoul,2018,30-39 Years old,317621,175648,141973
165,Seoul,2018,40-49 Years old,577124,304726,272398
166,Seoul,2018,50-59 Years old,611847,308204,303643
167,Seoul,2018,60-69 Years old,495253,259772,235481
168,Seoul,2018,70-79 Years old,297209,161201,136008
169,Seoul,2018,80 years and over,91093,46163,44930
170,Seoul,2018,dead,20873,15053,5820
171,Seoul,2019,Total,2483492,1297708,1185784
172,Seoul,2019,Under 30 years,47364,24017,23347
173,Seoul,2019,30-39 Years old,300102,164563,135539
174,Seoul,2019,40-49 Years old,569096,300689,268407
175,Seoul,2019,50-59 Years old,617201,309076,308125
176,Seoul,2019,60-69 Years old,514797,265841,248956
177,Seoul,2019,70-79 Years old,311186,166491,144695
178,Seoul,2019,80 years and over,102982,52244,50738
179,Seoul,2019,dead,20764,14787,5977
180,Seoul,2020,Total,2536442,1314345,1222097
181,Seoul,2020,Under 30 years,52860,26566,26294
182,Seoul,2020,30-39 Years old,298270,161985,136285
183,Seoul,2020,40-49 Years old,566321,298888,267433
184,Seoul,2020,50-59 Years old,621708,310376,311332
185,Seoul,2020,60-69 Years old,540208,274197,266011
186,Seoul,2020,70-79 Years old,322830,170555,152275
187,Seoul,2020,80 years and over,114439,57715,56724
188,Seoul,2020,dead,19806,14063,5743
189,Seoul,2021,Total,2602070,1340027,1262043
190,Seoul,2021,Under 30 years,59226,29402,29824
191,Seoul,2021,30-39 Years old,300627,161133,139494
192,Seoul,2021,40-49 Years old,564074,298662,265412
193,Seoul,2021,50-59 Years old,631377,315632,315745
194,Seoul,2021,60-69 Years old,570582,285677,284905
195,Seoul,2021,70-79 Years old,328358,171093,157265
196,Seoul,2021,80 years and over,127834,64419,63415
197,Seoul,2021,dead,19992,14009,5983
198,Seoul,2022,Total,2628669,1346726,1281943
199,Seoul,2022,Under 30 years,56660,28019,28641
200,Seoul,2022,30-39 Years old,281475,149501,131974
201,Seoul,2022,40-49 Years old,559966,297019,262947
202,Seoul,2022,50-59 Years old,641604,321544,320060
203,Seoul,2022,60-69 Years old,580581,287592,292989
204,Seoul,2022,70-79 Years old,340628,174971,165657
205,Seoul,2022,80 years and over,146204,73157,73047
206,Seoul,2022,dead,21551,14923,6628
207,Seoul,2023,Total,2643465,1348979,1294486
208,Seoul,2023,Under 30 years,51824,25655,26169
209,Seoul,2023,30-39 Years old,262277,138474,123803
210,Seoul,2023,40-49 Years old,550483,293063,257420
211,Seoul,2023,50-59 Years old,650148,326481,323667
212,Seoul,2023,60-69 Years old,593517,291916,301601
213,Seoul,2023,70-79 Years old,353318,179346,173972
214,Seoul,2023,80 years and over,160972,79709,81263
215,Seoul,2023,dead,20926,14335,6591
216,Busan,2012,Total,874492,487550,386942
217,Busan,2012,Under 30 years,19094,10215,8879
218,Busan,2012,30-39 Years old,126565,70752,55813
219,Busan,2012,40-49 Years old,203909,107822,96087
220,Busan,2012,50-59 Years old,249395,136761,112634
221,Busan,2012,60-69 Years old,163349,95909,67440
222,Busan,2012,70-79 Years old,82635,47211,35424
223,Busan,2012,80 years and over,15379,7841,7538
224,Busan,2012,dead,14166,11039,3127
225,Busan,2013,Total,909885,502201,407684
226,Busan,2013,Under 30 years,17269,9284,7985
227,Busan,2013,30-39 Years old,123796,69445,54351
228,Busan,2013,40-49 Years old,206055,108133,97922
229,Busan,2013,50-59 Years old,259126,139457,119669
230,Busan,2013,60-69 Years old,174590,100751,73839
231,Busan,2013,70-79 Years old,95219,53960,41259
232,Busan,2013,80 years and over,18793,9474,9319
233,Busan,2013,dead,15037,11697,3340
234,Busan,2014,Total,923056,504054,419002
235,Busan,2014,Under 30 years,16180,8839,7341
236,Busan,2014,30-39 Years old,121996,68918,53078
237,Busan,2014,40-49 Years old,208578,108603,99975
238,Busan,2014,50-59 Years old,257764,135487,122277
239,Busan,2014,60-69 Years old,181462,102749,78713
240,Busan,2014,70-79 Years old,100365,56597,43768
241,Busan,2014,80 years and over,20616,10340,10276
242,Busan,2014,dead,16095,12521,3574
243,Busan,2015,Total,950203,511698,438505
244,Busan,2015,Under 30 years,17804,9550,8254
245,Busan,2015,30-39 Years old,122574,69657,52917
246,Busan,2015,40-49 Years old,211192,109358,101834
247,Busan,2015,50-59 Years old,256893,131664,125229
248,Busan,2015,60-69 Years old,196100,108358,87742
249,Busan,2015,70-79 Years old,105793,59005,46788
250,Busan,2015,80 years and over,24128,12009,12119
251,Busan,2015,dead,15719,12097,3622
252,Busan,2016,Total,959418,510334,449084
253,Busan,2016,Under 30 years,16970,9119,7851
254,Busan,2016,30-39 Years old,121982,69615,52367
255,Busan,2016,40-49 Years old,210121,108339,101782
256,Busan,2016,50-59 Years old,254641,127638,127003
257,Busan,2016,60-69 Years old,205148,110601,94547
258,Busan,2016,70-79 Years old,107689,59515,48174
259,Busan,2016,80 years and over,27157,13486,13671
260,Busan,2016,dead,15710,12021,3689
261,Busan,2017,Total,973593,513794,459799
262,Busan,2017,Under 30 years,16588,8943,7645
263,Busan,2017,30-39 Years old,118460,67807,50653
264,Busan,2017,40-49 Years old,208817,108278,100539
265,Busan,2017,50-59 Years old,252548,124583,127965
266,Busan,2017,60-69 Years old,214267,113463,100804
267,Busan,2017,70-79 Years old,115600,62949,52651
268,Busan,2017,80 years and over,30924,15343,15581
269,Busan,2017,dead,16389,12428,3961
270,Busan,2018,Total,980424,513980,466444
271,Busan,2018,Under 30 years,15375,8256,7119
272,Busan,2018,30-39 Years old,112119,64299,47820
273,Busan,2018,40-49 Years old,205127,107292,97835
274,Busan,2018,50-59 Years old,251782,122656,129126
275,Busan,2018,60-69 Years old,220893,115030,105863
276,Busan,2018,70-79 Years old,122835,66139,56696
277,Busan,2018,80 years and over,34926,17292,17634
278,Busan,2018,dead,17367,13016,4351
279,Busan,2019,Total,986976,513969,473007
280,Busan,2019,Under 30 years,14107,7540,6567
281,Busan,2019,30-39 Years old,103194,59229,43965
282,Busan,2019,40-49 Years old,202929,107312,95617
283,Busan,2019,50-59 Years old,249838,120493,129345
284,Busan,2019,60-69 Years old,229175,117257,111918
285,Busan,2019,70-79 Years old,129547,68812,60735
286,Busan,2019,80 years and over,39629,19555,20074
287,Busan,2019,dead,18557,13771,4786
288,Busan,2020,Total,1001906,517709,484197
289,Busan,2020,Under 30 years,14337,7584,6753
290,Busan,2020,30-39 Years old,97286,55816,41470
291,Busan,2020,40-49 Years old,204662,109114,95548
292,Busan,2020,50-59 Years old,246238,118233,128005
293,Busan,2020,60-69 Years old,240931,120480,120451
294,Busan,2020,70-79 Years old,135123,70788,64335
295,Busan,2020,80 years and over,44323,21698,22625
296,Busan,2020,dead,19006,13996,5010
297,Busan,2021,Total,1019096,521484,497612
298,Busan,2021,Under 30 years,16372,8591,7781
299,Busan,2021,30-39 Years old,94141,53624,40517
300,Busan,2021,40-49 Years old,204191,109591,94600
301,Busan,2021,50-59 Years old,243735,116743,126992
302,Busan,2021,60-69 Years old,253198,123668,129530
303,Busan,2021,70-79 Years old,139640,71886,67754
304,Busan,2021,80 years and over,49490,23914,25576
305,Busan,2021,dead,18329,13467,4862
306,Busan,2022,Total,1030185,524025,506160
307,Busan,2022,Under 30 years,15960,8355,7605
308,Busan,2022,30-39 Years old,88663,50476,38187
309,Busan,2022,40-49 Years old,201989,109144,92845
310,Busan,2022,50-59 Years old,242329,116514,125815
311,Busan,2022,60-69 Years old,258354,124068,134286
312,Busan,2022,70-79 Years old,146791,74223,72568
313,Busan,2022,80 years and over,56513,27036,29477
314,Busan,2022,dead,19586,14209,5377
315,Busan,2023,Total,1051261,531965,519296
316,Busan,2023,Under 30 years,14460,7551,6909
317,Busan,2023,30-39 Years old,84989,48460,36529
318,Busan,2023,40-49 Years old,202455,110302,92153
319,Busan,2023,50-59 Years old,245421,118460,126961
320,Busan,2023,60-69 Years old,266290,126459,139831
321,Busan,2023,70-79 Years old,154637,76696,77941
322,Busan,2023,80 years and over,63039,29769,33270
323,Busan,2023,dead,19970,14268,5702
324,Daegu,2012,Total,594293,342198,252095
325,Daegu,2012,Under 30 years,11641,6685,4956
326,Daegu,2012,30-39 Years old,90101,51947,38154
327,Daegu,2012,40-49 Years old,159545,88828,70717
328,Daegu,2012,50-59 Years old,159789,91654,68135
329,Daegu,2012,60-69 Years old,98363,58231,40132
330,Daegu,2012,70-79 Years old,55576,32140,23436
331,Daegu,2012,80 years and over,11170,6156,5014
332,Daegu,2012,dead,8108,6557,1551
333,Daegu,2013,Total,611890,348109,263781
334,Daegu,2013,Under 30 years,10947,6333,4614
335,Daegu,2013,30-39 Years old,89773,51842,37931
336,Daegu,2013,40-49 Years old,161476,88556,72920
337,Daegu,2013,50-59 Years old,164894,92935,71959
338,Daegu,2013,60-69 Years old,102672,59659,43013
339,Daegu,2013,70-79 Years old,60641,34864,25777
340,Daegu,2013,80 years and over,13013,7072,5941
341,Daegu,2013,dead,8474,6848,1626
342,Daegu,2014,Total,623401,350796,272605
343,Daegu,2014,Under 30 years,10214,5983,4231
344,Daegu,2014,30-39 Years old,87882,51107,36775
345,Daegu,2014,40-49 Years old,163950,89026,74924
346,Daegu,2014,50-59 Years old,169137,93462,75675
347,Daegu,2014,60-69 Years old,106520,60981,45539
348,Daegu,2014,70-79 Years old,62886,35666,27220
349,Daegu,2014,80 years and over,13919,7374,6545
350,Daegu,2014,dead,8893,7197,1696
351,Daegu,2015,Total,639235,356387,282848
352,Daegu,2015,Under 30 years,10979,6389,4590
353,Daegu,2015,30-39 Years old,85017,49670,35347
354,Daegu,2015,40-49 Years old,163718,88440,75278
355,Daegu,2015,50-59 Years old,172457,93603,78854
356,Daegu,2015,60-69 Years old,115349,65041,50308
357,Daegu,2015,70-79 Years old,65519,36790,28729
358,Daegu,2015,80 years and over,16574,8704,7870
359,Daegu,2015,dead,9622,7750,1872
360,Daegu,2016,Total,653026,360678,292348
361,Daegu,2016,Under 30 years,10384,6098,4286
362,Daegu,2016,30-39 Years old,84104,49602,34502
363,Daegu,2016,40-49 Years old,164066,88296,75770
364,Daegu,2016,50-59 Years old,175563,93682,81881
365,Daegu,2016,60-69 Years old,123203,68178,55025
366,Daegu,2016,70-79 Years old,66796,37023,29773
367,Daegu,2016,80 years and over,19040,9935,9105
368,Daegu,2016,dead,9870,7864,2006
369,Daegu,2017,Total,671684,367859,303825
370,Daegu,2017,Under 30 years,10968,6482,4486
371,Daegu,2017,30-39 Years old,84329,50277,34052
372,Daegu,2017,40-49 Years old,165173,88844,76329
373,Daegu,2017,50-59 Years old,179524,94078,85446
374,Daegu,2017,60-69 Years old,129745,70689,59056
375,Daegu,2017,70-79 Years old,70855,38752,32103
376,Daegu,2017,80 years and over,21476,11096,10380
377,Daegu,2017,dead,9614,7641,1973
378,Daegu,2018,Total,683423,371500,311923
379,Daegu,2018,Under 30 years,11174,6478,4696
380,Daegu,2018,30-39 Years old,83708,50289,33419
381,Daegu,2018,40-49 Years old,162038,87371,74667
382,Daegu,2018,50-59 Years old,184010,95029,88981
383,Daegu,2018,60-69 Years old,133976,71916,62060
384,Daegu,2018,70-79 Years old,74500,40135,34365
385,Daegu,2018,80 years and over,24030,12437,11593
386,Daegu,2018,dead,9987,7845,2142
387,Daegu,2019,Total,690770,371768,319002
388,Daegu,2019,Under 30 years,10932,6286,4646
389,Daegu,2019,30-39 Years old,79337,48012,31325
390,Daegu,2019,40-49 Years old,159955,86421,73534
391,Daegu,2019,50-59 Years old,185774,94628,91146
392,Daegu,2019,60-69 Years old,139873,73625,66248
393,Daegu,2019,70-79 Years old,78287,41514,36773
394,Daegu,2019,80 years and over,27019,13809,13210
395,Daegu,2019,dead,9593,7473,2120
396,Daegu,2020,Total,698114,372185,325929
397,Daegu,2020,Under 30 years,10879,6185,4694
398,Daegu,2020,30-39 Years old,73946,44947,28999
399,Daegu,2020,40-49 Years old,157668,85564,72104
400,Daegu,2020,50-59 Years old,186209,93844,92365
401,Daegu,2020,60-69 Years old,148216,76354,71862
402,Daegu,2020,70-79 Years old,81304,42638,38666
403,Daegu,2020,80 years and over,29957,15013,14944
404,Daegu,2020,dead,9935,7640,2295
405,Daegu,2021,Total,709100,375286,333814
406,Daegu,2021,Under 30 years,11501,6488,5013
407,Daegu,2021,30-39 Years old,70239,42795,27444
408,Daegu,2021,40-49 Years old,155283,84875,70408
409,Daegu,2021,50-59 Years old,186623,93572,93051
410,Daegu,2021,60-69 Years old,158022,80038,77984
411,Daegu,2021,70-79 Years old,83923,43418,40505
412,Daegu,2021,80 years and over,33459,16442,17017
413,Daegu,2021,dead,10050,7658,2392
414,Daegu,2022,Total,717264,377734,339530
415,Daegu,2022,Under 30 years,10505,5896,4609
416,Daegu,2022,30-39 Years old,65316,39910,25406
417,Daegu,2022,40-49 Years old,153519,84717,68802
418,Daegu,2022,50-59 Years old,187803,94115,93688
419,Daegu,2022,60-69 Years old,162878,81597,81281
420,Daegu,2022,70-79 Years old,88265,44872,43393
421,Daegu,2022,80 years and over,37956,18448,19508
422,Daegu,2022,dead,11022,8179,2843
423,Daegu,2023,Total,740776,389746,351030
424,Daegu,2023,Under 30 years,9802,5432,4370
425,Daegu,2023,30-39 Years old,63134,38900,24234
426,Daegu,2023,40-49 Years old,151492,84645,66847
427,Daegu,2023,50-59 Years old,192717,96595,96122
428,Daegu,2023,60-69 Years old,172354,85949,86405
429,Daegu,2023,70-79 Years old,94915,47632,47283
430,Daegu,2023,80 years and over,43420,20956,22464
431,Daegu,2023,dead,12942,9637,3305
432,Incheon,2012,Total,677829,387338,290491
433,Incheon,2012,Under 30 years,20233,10597,9636
434,Incheon,2012,30-39 Years old,123261,72587,50674
435,Incheon,2012,40-49 Years old,189263,106825,82438
436,Incheon,2012,50-59 Years old,181695,104236,77459
437,Incheon,2012,60-69 Years old,93734,53892,39842
438,Incheon,2012,70-79 Years old,50054,26995,23059
439,Incheon,2012,80 years and over,10920,5503,5417
440,Incheon,2012,dead,8669,6703,1966
441,Incheon,2013,Total,695488,394998,300490
442,Incheon,2013,Under 30 years,17369,9122,8247
443,Incheon,2013,30-39 Years old,118060,69695,48365
444,Incheon,2013,40-49 Years old,190686,106835,83851
445,Incheon,2013,50-59 Years old,192363,109157,83206
446,Incheon,2013,60-69 Years old,99380,56770,42610
447,Incheon,2013,70-79 Years old,55548,30009,25539
448,Incheon,2013,80 years and over,13074,6437,6637
449,Incheon,2013,dead,9008,6973,2035
450,Incheon,2014,Total,709536,398844,310692
451,Incheon,2014,Under 30 years,16256,8608,7648
452,Incheon,2014,30-39 Years old,115609,68345,47264
453,Incheon,2014,40-49 Years old,192712,107014,85698
454,Incheon,2014,50-59 Years old,198227,110335,87892
455,Incheon,2014,60-69 Years old,104903,59145,45758
456,Incheon,2014,70-79 Years old,58255,31297,26958
457,Incheon,2014,80 years and over,14116,6762,7354
458,Incheon,2014,dead,9458,7338,2120
459,Incheon,2015,Total,732615,407800,324815
460,Incheon,2015,Under 30 years,17631,9343,8288
461,Incheon,2015,30-39 Years old,116952,69416,47536
462,Incheon,2015,40-49 Years old,193975,107129,86846
463,Incheon,2015,50-59 Years old,204251,111512,92739
464,Incheon,2015,60-69 Years old,114070,63318,50752
465,Incheon,2015,70-79 Years old,60669,32359,28310
466,Incheon,2015,80 years and over,16044,7717,8327
467,Incheon,2015,dead,9023,7006,2017
468,Incheon,2016,Total,746413,412015,334398
469,Incheon,2016,Under 30 years,16665,8825,7840
470,Incheon,2016,30-39 Years old,114762,68323,46439
471,Incheon,2016,40-49 Years old,193511,106573,86938
472,Incheon,2016,50-59 Years old,208113,111955,96158
473,Incheon,2016,60-69 Years old,122140,66787,55353
474,Incheon,2016,70-79 Years old,63441,33542,29899
475,Incheon,2016,80 years and over,18449,8819,9630
476,Incheon,2016,dead,9332,7191,2141
477,Incheon,2017,Total,763252,417893,345359
478,Incheon,2017,Under 30 years,16933,8882,8051
479,Incheon,2017,30-39 Years old,112201,66904,45297
480,Incheon,2017,40-49 Years old,194828,107368,87460
481,Incheon,2017,50-59 Years old,212142,112254,99888
482,Incheon,2017,60-69 Years old,129848,70196,59652
483,Incheon,2017,70-79 Years old,68012,35700,32312
484,Incheon,2017,80 years and over,20326,9706,10620
485,Incheon,2017,dead,8962,6883,2079
486,Incheon,2018,Total,780533,424105,356428
487,Incheon,2018,Under 30 years,16910,8891,8019
488,Incheon,2018,30-39 Years old,110551,65714,44837
489,Incheon,2018,40-49 Years old,193674,107261,86413
490,Incheon,2018,50-59 Years old,217411,113236,104175
491,Incheon,2018,60-69 Years old,138325,73733,64592
492,Incheon,2018,70-79 Years old,71445,37268,34177
493,Incheon,2018,80 years and over,22881,10916,11965
494,Incheon,2018,dead,9336,7086,2250
495,Incheon,2019,Total,791488,427231,364257
496,Incheon,2019,Under 30 years,15939,8310,7629
497,Incheon,2019,30-39 Years old,104222,61754,42468
498,Incheon,2019,40-49 Years old,192116,107171,84945
499,Incheon,2019,50-59 Years old,220468,113625,106843
500,Incheon,2019,60-69 Years old,148165,78043,70122
501,Incheon,2019,70-79 Years old,75393,39077,36316
502,Incheon,2019,80 years and over,25610,12084,13526
503,Incheon,2019,dead,9575,7167,2408
504,Incheon,2020,Total,803261,430338,372923
505,Incheon,2020,Under 30 years,16330,8495,7835
506,Incheon,2020,30-39 Years old,97222,57320,39902
507,Incheon,2020,40-49 Years old,191658,107703,83955
508,Incheon,2020,50-59 Years old,220019,112470,107549
509,Incheon,2020,60-69 Years old,161266,83588,77678
510,Incheon,2020,70-79 Years old,79230,40669,38561
511,Incheon,2020,80 years and over,28088,13067,15021
512,Incheon,2020,dead,9448,7026,2422
513,Incheon,2021,Total,822999,438763,384236
514,Incheon,2021,Under 30 years,18115,9502,8613
515,Incheon,2021,30-39 Years old,94080,55353,38727
516,Incheon,2021,40-49 Years old,190933,108199,82734
517,Incheon,2021,50-59 Years old,220809,112511,108298
518,Incheon,2021,60-69 Years old,177680,91095,86585
519,Incheon,2021,70-79 Years old,81344,41228,40116
520,Incheon,2021,80 years and over,31068,14273,16795
521,Incheon,2021,dead,8970,6602,2368
522,Incheon,2022,Total,839794,446044,393750
523,Incheon,2022,Under 30 years,16719,8721,7998
524,Incheon,2022,30-39 Years old,88634,51802,36832
525,Incheon,2022,40-49 Years old,191443,109296,82147
526,Incheon,2022,50-59 Years old,223227,113851,109376
527,Incheon,2022,60-69 Years old,188317,95724,92593
528,Incheon,2022,70-79 Years old,86226,43547,42679
529,Incheon,2022,80 years and over,35294,15958,19336
530,Incheon,2022,dead,9934,7145,2789
531,Incheon,2023,Total,864282,458051,406231
532,Incheon,2023,Under 30 years,14735,7692,7043
533,Incheon,2023,30-39 Years old,86757,50468,36289
534,Incheon,2023,40-49 Years old,192496,111156,81340
535,Incheon,2023,50-59 Years old,226962,115789,111173
536,Incheon,2023,60-69 Years old,201176,101431,99745
537,Incheon,2023,70-79 Years old,91216,45793,45423
538,Incheon,2023,80 years and over,39376,17578,21798
539,Incheon,2023,dead,11564,8144,3420
540,Gwangju,2012,Total,348858,192837,156021
541,Gwangju,2012,Under 30 years,9569,5313,4256
542,Gwangju,2012,30-39 Years old,64527,35484,29043
543,Gwangju,2012,40-49 Years old,97662,51388,46274
544,Gwangju,2012,50-59 Years old,81738,44784,36954
545,Gwangju,2012,60-69 Years old,52507,30348,22159
546,Gwangju,2012,70-79 Years old,30450,17275,13175
547,Gwangju,2012,80 years and over,6499,3481,3018
548,Gwangju,2012,dead,5906,4764,1142
549,Gwangju,2013,Total,354659,194360,160299
550,Gwangju,2013,Under 30 years,8331,4655,3676
551,Gwangju,2013,30-39 Years old,61201,33945,27256
552,Gwangju,2013,40-49 Years old,98997,51403,47594
553,Gwangju,2013,50-59 Years old,85947,46417,39530
554,Gwangju,2013,60-69 Years old,54104,30839,23265
555,Gwangju,2013,70-79 Years old,32608,18342,14266
556,Gwangju,2013,80 years and over,7371,3850,3521
557,Gwangju,2013,dead,6100,4909,1191
558,Gwangju,2014,Total,373513,203657,169856
559,Gwangju,2014,Under 30 years,8254,4632,3622
560,Gwangju,2014,30-39 Years old,61996,34757,27239
561,Gwangju,2014,40-49 Years old,105032,54343,50689
562,Gwangju,2014,50-59 Years old,92186,49296,42890
563,Gwangju,2014,60-69 Years old,57399,32400,24999
564,Gwangju,2014,70-79 Years old,34151,19002,15149
565,Gwangju,2014,80 years and over,8144,4122,4022
566,Gwangju,2014,dead,6351,5105,1246
567,Gwangju,2015,Total,386295,208743,177552
568,Gwangju,2015,Under 30 years,8715,4885,3830
569,Gwangju,2015,30-39 Years old,62407,35597,26810
570,Gwangju,2015,40-49 Years old,106943,54950,51993
571,Gwangju,2015,50-59 Years old,95553,50154,45399
572,Gwangju,2015,60-69 Years old,61440,33767,27673
573,Gwangju,2015,70-79 Years old,35923,19889,16034
574,Gwangju,2015,80 years and over,9260,4671,4589
575,Gwangju,2015,dead,6054,4830,1224
576,Gwangju,2016,Total,393535,211029,182506
577,Gwangju,2016,Under 30 years,8066,4546,3520
578,Gwangju,2016,30-39 Years old,59862,34404,25458
579,Gwangju,2016,40-49 Years old,107212,54958,52254
580,Gwangju,2016,50-59 Years old,99482,51413,48069
581,Gwangju,2016,60-69 Years old,64460,34778,29682
582,Gwangju,2016,70-79 Years old,37600,20656,16944
583,Gwangju,2016,80 years and over,10707,5381,5326
584,Gwangju,2016,dead,6146,4893,1253
585,Gwangju,2017,Total,399189,212848,186341
586,Gwangju,2017,Under 30 years,7966,4459,3507
587,Gwangju,2017,30-39 Years old,57105,33168,23937
588,Gwangju,2017,40-49 Years old,107398,55154,52244
589,Gwangju,2017,50-59 Years old,101452,51701,49751
590,Gwangju,2017,60-69 Years old,67059,35730,31329
591,Gwangju,2017,70-79 Years old,40068,21763,18305
592,Gwangju,2017,80 years and over,11884,5918,5966
593,Gwangju,2017,dead,6257,4955,1302
594,Gwangju,2018,Total,406703,214953,191750
595,Gwangju,2018,Under 30 years,8465,4743,3722
596,Gwangju,2018,30-39 Years old,56703,33203,23500
597,Gwangju,2018,40-49 Years old,105963,54653,51310
598,Gwangju,2018,50-59 Years old,104883,52503,52380
599,Gwangju,2018,60-69 Years old,69594,36249,33345
600,Gwangju,2018,70-79 Years old,41916,22381,19535
601,Gwangju,2018,80 years and over,13217,6565,6652
602,Gwangju,2018,dead,5962,4656,1306
603,Gwangju,2019,Total,414198,217349,196849
604,Gwangju,2019,Under 30 years,8522,4762,3760
605,Gwangju,2019,30-39 Years old,54170,31893,22277
606,Gwangju,2019,40-49 Years old,105585,54868,50717
607,Gwangju,2019,50-59 Years old,107579,53267,54312
608,Gwangju,2019,60-69 Years old,73588,37616,35972
609,Gwangju,2019,70-79 Years old,44173,23144,21029
610,Gwangju,2019,80 years and over,14901,7375,7526
611,Gwangju,2019,dead,5680,4424,1256
612,Gwangju,2020,Total,419407,218556,200851
613,Gwangju,2020,Under 30 years,8512,4686,3826
614,Gwangju,2020,30-39 Years old,50792,29932,20860
615,Gwangju,2020,40-49 Years old,104631,54734,49897
616,Gwangju,2020,50-59 Years old,107970,53042,54928
617,Gwangju,2020,60-69 Years old,78791,39598,39193
618,Gwangju,2020,70-79 Years old,46019,23825,22194
619,Gwangju,2020,80 years and over,16651,8123,8528
620,Gwangju,2020,dead,6041,4616,1425
621,Gwangju,2021,Total,430443,222863,207580
622,Gwangju,2021,Under 30 years,9260,5088,4172
623,Gwangju,2021,30-39 Years old,49538,29331,20207
624,Gwangju,2021,40-49 Years old,104279,55223,49056
625,Gwangju,2021,50-59 Years old,111066,54160,56906
626,Gwangju,2021,60-69 Years old,84374,41478,42896
627,Gwangju,2021,70-79 Years old,47463,24172,23291
628,Gwangju,2021,80 years and over,18664,9012,9652
629,Gwangju,2021,dead,5799,4399,1400
630,Gwangju,2022,Total,436853,225185,211668
631,Gwangju,2022,Under 30 years,8928,4819,4109
632,Gwangju,2022,30-39 Years old,46778,27743,19035
633,Gwangju,2022,40-49 Years old,103348,55439,47909
634,Gwangju,2022,50-59 Years old,113932,55413,58519
635,Gwangju,2022,60-69 Years old,87557,42529,45028
636,Gwangju,2022,70-79 Years old,48912,24470,24442
637,Gwangju,2022,80 years and over,21481,10358,11123
638,Gwangju,2022,dead,5917,4414,1503
639,Gwangju,2023,Total,443367,227412,215955
640,Gwangju,2023,Under 30 years,8268,4454,3814
641,Gwangju,2023,30-39 Years old,44358,26281,18077
642,Gwangju,2023,40-49 Years old,101839,55506,46333
643,Gwangju,2023,50-59 Years old,116613,56571,60042
644,Gwangju,2023,60-69 Years old,92269,44231,48038
645,Gwangju,2023,70-79 Years old,50861,24935,25926
646,Gwangju,2023,80 years and over,23294,11087,12207
647,Gwangju,2023,dead,5865,4347,1518
648,Daejeon,2012,Total,359070,206642,152428
649,Daejeon,2012,Under 30 years,9047,5059,3988
650,Daejeon,2012,30-39 Years old,63974,36310,27664
651,Daejeon,2012,40-49 Years old,100457,56695,43762
652,Daejeon,2012,50-59 Years old,95804,55415,40389
653,Daejeon,2012,60-69 Years old,51609,30602,21007
654,Daejeon,2012,70-79 Years old,28486,16353,12133
655,Daejeon,2012,80 years and over,5993,3256,2737
656,Daejeon,2012,dead,3700,2952,748
657,Daejeon,2013,Total,366120,208817,157303
658,Daejeon,2013,Under 30 years,7962,4491,3471
659,Daejeon,2013,30-39 Years old,60891,34409,26482
660,Daejeon,2013,40-49 Years old,102219,56958,45261
661,Daejeon,2013,50-59 Years old,99050,56571,42479
662,Daejeon,2013,60-69 Years old,54267,31891,22376
663,Daejeon,2013,70-79 Years old,30873,17639,13234
664,Daejeon,2013,80 years and over,6940,3731,3209
665,Daejeon,2013,dead,3918,3127,791
666,Daejeon,2014,Total,380020,215380,164640
667,Daejeon,2014,Under 30 years,7841,4456,3385
668,Daejeon,2014,30-39 Years old,60169,34222,25947
669,Daejeon,2014,40-49 Years old,106227,58811,47416
670,Daejeon,2014,50-59 Years old,102718,58002,44716
671,Daejeon,2014,60-69 Years old,58302,33889,24413
672,Daejeon,2014,70-79 Years old,32776,18606,14170
673,Daejeon,2014,80 years and over,7832,4084,3748
674,Daejeon,2014,dead,4155,3310,845
675,Daejeon,2015,Total,391520,219531,171989
676,Daejeon,2015,Under 30 years,8237,4695,3542
677,Daejeon,2015,30-39 Years old,59323,33874,25449
678,Daejeon,2015,40-49 Years old,107544,59034,48510
679,Daejeon,2015,50-59 Years old,104738,57898,46840
680,Daejeon,2015,60-69 Years old,63858,36531,27327
681,Daejeon,2015,70-79 Years old,34584,19491,15093
682,Daejeon,2015,80 years and over,9227,4839,4388
683,Daejeon,2015,dead,4009,3169,840
684,Daejeon,2016,Total,395168,219542,175626
685,Daejeon,2016,Under 30 years,7469,4273,3196
686,Daejeon,2016,30-39 Years old,56647,32669,23978
687,Daejeon,2016,40-49 Years old,107383,58371,49012
688,Daejeon,2016,50-59 Years old,105318,57305,48013
689,Daejeon,2016,60-69 Years old,68089,38354,29735
690,Daejeon,2016,70-79 Years old,35675,19909,15766
691,Daejeon,2016,80 years and over,10576,5483,5093
692,Daejeon,2016,dead,4011,3178,833
693,Daejeon,2017,Total,394868,217981,176887
694,Daejeon,2017,Under 30 years,7142,4096,3046
695,Daejeon,2017,30-39 Years old,52047,30216,21831
696,Daejeon,2017,40-49 Years old,105453,57063,48390
697,Daejeon,2017,50-59 Years old,104986,56349,48637
698,Daejeon,2017,60-69 Years old,71603,40030,31573
699,Daejeon,2017,70-79 Years old,37610,20800,16810
700,Daejeon,2017,80 years and over,11834,6132,5702
701,Daejeon,2017,dead,4193,3295,898
702,Daejeon,2018,Total,402344,219888,182456
703,Daejeon,2018,Under 30 years,7282,4100,3182
704,Daejeon,2018,30-39 Years old,51337,29993,21344
705,Daejeon,2018,40-49 Years old,103574,55868,47706
706,Daejeon,2018,50-59 Years old,107625,56759,50866
707,Daejeon,2018,60-69 Years old,75127,41270,33857
708,Daejeon,2018,70-79 Years old,39704,21652,18052
709,Daejeon,2018,80 years and over,13484,6971,6513
710,Daejeon,2018,dead,4211,3275,936
711,Daejeon,2019,Total,404201,219331,184870
712,Daejeon,2019,Under 30 years,6983,3883,3100
713,Daejeon,2019,30-39 Years old,47835,28041,19794
714,Daejeon,2019,40-49 Years old,100630,54428,46202
715,Daejeon,2019,50-59 Years old,108958,57002,51956
716,Daejeon,2019,60-69 Years old,78809,42453,36356
717,Daejeon,2019,70-79 Years old,41447,22388,19059
718,Daejeon,2019,80 years and over,15119,7745,7374
719,Daejeon,2019,dead,4420,3391,1029
720,Daejeon,2020,Total,410730,220324,190406
721,Daejeon,2020,Under 30 years,7698,4250,3448
722,Daejeon,2020,30-39 Years old,45973,26758,19215
723,Daejeon,2020,40-49 Years old,99515,53625,45890
724,Daejeon,2020,50-59 Years old,109112,56710,52402
725,Daejeon,2020,60-69 Years old,83907,44182,39725
726,Daejeon,2020,70-79 Years old,43716,23235,20481
727,Daejeon,2020,80 years and over,16465,8269,8196
728,Daejeon,2020,dead,4344,3295,1049
729,Daejeon,2021,Total,418833,222952,195881
730,Daejeon,2021,Under 30 years,8595,4671,3924
731,Daejeon,2021,30-39 Years old,44516,26017,18499
732,Daejeon,2021,40-49 Years old,97430,52575,44855
733,Daejeon,2021,50-59 Years old,109965,56792,53173
734,Daejeon,2021,60-69 Years old,90860,47018,43842
735,Daejeon,2021,70-79 Years old,45094,23747,21347
736,Daejeon,2021,80 years and over,18164,8989,9175
737,Daejeon,2021,dead,4209,3143,1066
738,Daejeon,2022,Total,425773,225651,200122
739,Daejeon,2022,Under 30 years,8156,4405,3751
740,Daejeon,2022,30-39 Years old,42432,24843,17589
741,Daejeon,2022,40-49 Years old,96605,52431,44174
742,Daejeon,2022,50-59 Years old,111527,57515,54012
743,Daejeon,2022,60-69 Years old,94747,48493,46254
744,Daejeon,2022,70-79 Years old,46827,24373,22454
745,Daejeon,2022,80 years and over,20784,10167,10617
746,Daejeon,2022,dead,4695,3424,1271
747,Daejeon,2023,Total,433503,229165,204338
748,Daejeon,2023,Under 30 years,7519,4071,3448
749,Daejeon,2023,30-39 Years old,41159,24106,17053
750,Daejeon,2023,40-49 Years old,95104,52190,42914
751,Daejeon,2023,50-59 Years old,114589,58972,55617
752,Daejeon,2023,60-69 Years old,98302,49967,48335
753,Daejeon,2023,70-79 Years old,49248,25439,23809
754,Daejeon,2023,80 years and over,22550,10808,11742
755,Daejeon,2023,dead,5032,3612,1420
756,Ulsan,2012,Total,291434,180908,110526
757,Ulsan,2012,Under 30 years,7736,4667,3069
758,Ulsan,2012,30-39 Years old,55821,34552,21269
759,Ulsan,2012,40-49 Years old,87673,53296,34377
760,Ulsan,2012,50-59 Years old,81521,51670,29851
761,Ulsan,2012,60-69 Years old,37214,23654,13560
762,Ulsan,2012,70-79 Years old,15534,9117,6417
763,Ulsan,2012,80 years and over,2733,1400,1333
764,Ulsan,2012,dead,3202,2552,650
765,Ulsan,2013,Total,301663,185327,116336
766,Ulsan,2013,Under 30 years,6941,4238,2703
767,Ulsan,2013,30-39 Years old,55216,34549,20667
768,Ulsan,2013,40-49 Years old,88415,52554,35861
769,Ulsan,2013,50-59 Years old,86721,54093,32628
770,Ulsan,2013,60-69 Years old,40383,25398,14985
771,Ulsan,2013,70-79 Years old,17378,10170,7208
772,Ulsan,2013,80 years and over,3232,1637,1595
773,Ulsan,2013,dead,3377,2688,689
774,Ulsan,2014,Total,311549,189958,121591
775,Ulsan,2014,Under 30 years,6600,4145,2455
776,Ulsan,2014,30-39 Years old,55767,35277,20490
777,Ulsan,2014,40-49 Years old,90026,52763,37263
778,Ulsan,2014,50-59 Years old,90448,55428,35020
779,Ulsan,2014,60-69 Years old,43346,27133,16213
780,Ulsan,2014,70-79 Years old,18221,10553,7668
781,Ulsan,2014,80 years and over,3520,1783,1737
782,Ulsan,2014,dead,3621,2876,745
783,Ulsan,2015,Total,325450,196542,128908
784,Ulsan,2015,Under 30 years,7345,4668,2677
785,Ulsan,2015,30-39 Years old,57793,37163,20630
786,Ulsan,2015,40-49 Years old,90150,52026,38124
787,Ulsan,2015,50-59 Years old,94702,56912,37790
788,Ulsan,2015,60-69 Years old,48320,29690,18630
789,Ulsan,2015,70-79 Years old,19545,11223,8322
790,Ulsan,2015,80 years and over,4040,2039,2001
791,Ulsan,2015,dead,3555,2821,734
792,Ulsan,2016,Total,331064,198577,132487
793,Ulsan,2016,Under 30 years,6763,4277,2486
794,Ulsan,2016,30-39 Years old,57133,37033,20100
795,Ulsan,2016,40-49 Years old,88427,50614,37813
796,Ulsan,2016,50-59 Years old,97254,57768,39486
797,Ulsan,2016,60-69 Years old,52624,31891,20733
798,Ulsan,2016,70-79 Years old,20530,11762,8768
799,Ulsan,2016,80 years and over,4672,2332,2340
800,Ulsan,2016,dead,3661,2900,761
801,Ulsan,2017,Total,338232,202151,136081
802,Ulsan,2017,Under 30 years,6620,4200,2420
803,Ulsan,2017,30-39 Years old,55865,36496,19369
804,Ulsan,2017,40-49 Years old,88118,50689,37429
805,Ulsan,2017,50-59 Years old,99521,58482,41039
806,Ulsan,2017,60-69 Years old,56785,33937,22848
807,Ulsan,2017,70-79 Years old,22455,12875,9580
808,Ulsan,2017,80 years and over,5251,2632,2619
809,Ulsan,2017,dead,3617,2840,777
810,Ulsan,2018,Total,343884,204605,139279
811,Ulsan,2018,Under 30 years,6484,4095,2389
812,Ulsan,2018,30-39 Years old,54574,35866,18708
813,Ulsan,2018,40-49 Years old,86770,50233,36537
814,Ulsan,2018,50-59 Years old,102061,59217,42844
815,Ulsan,2018,60-69 Years old,60336,35544,24792
816,Ulsan,2018,70-79 Years old,24095,13849,10246
817,Ulsan,2018,80 years and over,5755,2834,2921
818,Ulsan,2018,dead,3809,2967,842
819,Ulsan,2019,Total,351519,208416,143103
820,Ulsan,2019,Under 30 years,5838,3582,2256
821,Ulsan,2019,30-39 Years old,51607,34040,17567
822,Ulsan,2019,40-49 Years old,86443,50513,35930
823,Ulsan,2019,50-59 Years old,104087,59803,44284
824,Ulsan,2019,60-69 Years old,65819,38438,27381
825,Ulsan,2019,70-79 Years old,26645,15361,11284
826,Ulsan,2019,80 years and over,6916,3472,3444
827,Ulsan,2019,dead,4164,3207,957
828,Ulsan,2020,Total,358845,211198,147647
829,Ulsan,2020,Under 30 years,6266,3819,2447
830,Ulsan,2020,30-39 Years old,49085,32367,16718
831,Ulsan,2020,40-49 Years old,87153,51387,35766
832,Ulsan,2020,50-59 Years old,104114,59064,45050
833,Ulsan,2020,60-69 Years old,71695,41197,30498
834,Ulsan,2020,70-79 Years old,28610,16365,12245
835,Ulsan,2020,80 years and over,7854,3920,3934
836,Ulsan,2020,dead,4068,3079,989
837,Ulsan,2021,Total,361641,211574,150067
838,Ulsan,2021,Under 30 years,6334,3878,2456
839,Ulsan,2021,30-39 Years old,45286,29639,15647
840,Ulsan,2021,40-49 Years old,85807,51131,34676
841,Ulsan,2021,50-59 Years old,102864,57874,44990
842,Ulsan,2021,60-69 Years old,77854,44175,33679
843,Ulsan,2021,70-79 Years old,30628,17443,13185
844,Ulsan,2021,80 years and over,8782,4352,4430
845,Ulsan,2021,dead,4086,3082,1004
846,Ulsan,2022,Total,363002,211411,151591
847,Ulsan,2022,Under 30 years,5692,3455,2237
848,Ulsan,2022,30-39 Years old,40966,26874,14092
849,Ulsan,2022,40-49 Years old,84819,51089,33730
850,Ulsan,2022,50-59 Years old,101822,56816,45006
851,Ulsan,2022,60-69 Years old,82197,46296,35901
852,Ulsan,2022,70-79 Years old,33139,18717,14422
853,Ulsan,2022,80 years and over,10226,5072,5154
854,Ulsan,2022,dead,4141,3092,1049
855,Ulsan,2023,Total,364550,211582,152968
856,Ulsan,2023,Under 30 years,4759,2900,1859
857,Ulsan,2023,30-39 Years old,36810,24162,12648
858,Ulsan,2023,40-49 Years old,82728,50406,32322
859,Ulsan,2023,50-59 Years old,101611,56279,45332
860,Ulsan,2023,60-69 Years old,86540,48558,37982
861,Ulsan,2023,70-79 Years old,35819,20129,15690
862,Ulsan,2023,80 years and over,11585,5714,5871
863,Ulsan,2023,dead,4698,3434,1264
864,Sejong,2012,Total,27165,17277,9888
865,Sejong,2012,Under 30 years,515,332,183
866,Sejong,2012,30-39 Years old,4437,2738,1699
867,Sejong,2012,40-49 Years old,6026,3841,2185
868,Sejong,2012,50-59 Years old,6331,3953,2378
869,Sejong,2012,60-69 Years old,4451,2756,1695
870,Sejong,2012,70-79 Years old,3434,2176,1258
871,Sejong,2012,80 years and over,921,567,354
872,Sejong,2012,dead,1050,914,136
873,Sejong,2013,Total,29421,18605,10816
874,Sejong,2013,Under 30 years,522,332,190
875,Sejong,2013,30-39 Years old,4489,2704,1785
876,Sejong,2013,40-49 Years old,6840,4335,2505
877,Sejong,2013,50-59 Years old,6861,4275,2586
878,Sejong,2013,60-69 Years old,4757,2944,1813
879,Sejong,2013,70-79 Years old,3679,2316,1363
880,Sejong,2013,80 years and over,1100,672,428
881,Sejong,2013,dead,1173,1027,146
882,Sejong,2014,Total,33459,20745,12714
883,Sejong,2014,Under 30 years,718,455,263
884,Sejong,2014,30-39 Years old,5462,3244,2218
885,Sejong,2014,40-49 Years old,8656,5393,3263
886,Sejong,2014,50-59 Years old,7531,4556,2975
887,Sejong,2014,60-69 Years old,5014,3062,1952
888,Sejong,2014,70-79 Years old,3711,2278,1433
889,Sejong,2014,80 years and over,1081,630,451
890,Sejong,2014,dead,1286,1127,159
891,Sejong,2015,Total,49659,29836,19823
892,Sejong,2015,Under 30 years,1088,645,443
893,Sejong,2015,30-39 Years old,10896,6363,4533
894,Sejong,2015,40-49 Years old,14642,8919,5723
895,Sejong,2015,50-59 Years old,10360,6014,4346
896,Sejong,2015,60-69 Years old,6340,3760,2580
897,Sejong,2015,70-79 Years old,3869,2356,1513
898,Sejong,2015,80 years and over,1197,679,518
899,Sejong,2015,dead,1267,1100,167
900,Sejong,2016,Total,58322,34585,23737
901,Sejong,2016,Under 30 years,1180,677,503
902,Sejong,2016,30-39 Years old,12708,7529,5179
903,Sejong,2016,40-49 Years old,17907,10751,7156
904,Sejong,2016,50-59 Years old,12040,6832,5208
905,Sejong,2016,60-69 Years old,7664,4403,3261
906,Sejong,2016,70-79 Years old,4119,2439,1680
907,Sejong,2016,80 years and over,1402,810,592
908,Sejong,2016,dead,1302,1144,158
909,Sejong,2017,Total,69759,40737,29022
910,Sejong,2017,Under 30 years,1358,751,607
911,Sejong,2017,30-39 Years old,15073,8753,6320
912,Sejong,2017,40-49 Years old,22006,13042,8964
913,Sejong,2017,50-59 Years old,14480,8099,6381
914,Sejong,2017,60-69 Years old,9177,5205,3972
915,Sejong,2017,70-79 Years old,4656,2742,1914
916,Sejong,2017,80 years and over,1645,947,698
917,Sejong,2017,dead,1364,1198,166
918,Sejong,2018,Total,81225,46831,34394
919,Sejong,2018,Under 30 years,1650,879,771
920,Sejong,2018,30-39 Years old,17609,10190,7419
921,Sejong,2018,40-49 Years old,25735,15056,10679
922,Sejong,2018,50-59 Years old,17179,9488,7691
923,Sejong,2018,60-69 Years old,10749,6026,4723
924,Sejong,2018,70-79 Years old,5072,2915,2157
925,Sejong,2018,80 years and over,1890,1115,775
926,Sejong,2018,dead,1341,1162,179
927,Sejong,2019,Total,87537,50056,37481
928,Sejong,2019,Under 30 years,1566,806,760
929,Sejong,2019,30-39 Years old,17343,10010,7333
930,Sejong,2019,40-49 Years old,28177,16366,11811
931,Sejong,2019,50-59 Years old,19373,10648,8725
932,Sejong,2019,60-69 Years old,12027,6635,5392
933,Sejong,2019,70-79 Years old,5509,3148,2361
934,Sejong,2019,80 years and over,2127,1223,904
935,Sejong,2019,dead,1415,1220,195
936,Sejong,2020,Total,93116,52776,40340
937,Sejong,2020,Under 30 years,1671,859,812
938,Sejong,2020,30-39 Years old,16913,9561,7352
939,Sejong,2020,40-49 Years old,30303,17468,12835
940,Sejong,2020,50-59 Years old,21043,11623,9420
941,Sejong,2020,60-69 Years old,13402,7299,6103
942,Sejong,2020,70-79 Years old,5987,3387,2600
943,Sejong,2020,80 years and over,2292,1300,992
944,Sejong,2020,dead,1505,1279,226
945,Sejong,2021,Total,99104,55730,43374
946,Sejong,2021,Under 30 years,1793,940,853
947,Sejong,2021,30-39 Years old,16371,9169,7202
948,Sejong,2021,40-49 Years old,31995,18298,13697
949,Sejong,2021,50-59 Years old,23097,12788,10309
950,Sejong,2021,60-69 Years old,15471,8312,7159
951,Sejong,2021,70-79 Years old,6277,3513,2764
952,Sejong,2021,80 years and over,2530,1389,1141
953,Sejong,2021,dead,1570,1321,249
954,Sejong,2022,Total,113799,63267,50532
955,Sejong,2022,Under 30 years,2151,1024,1127
956,Sejong,2022,30-39 Years old,19119,10501,8618
957,Sejong,2022,40-49 Years old,36987,20980,16007
958,Sejong,2022,50-59 Years old,26680,14823,11857
959,Sejong,2022,60-69 Years old,17345,9222,8123
960,Sejong,2022,70-79 Years old,7070,3881,3189
961,Sejong,2022,80 years and over,2886,1564,1322
962,Sejong,2022,dead,1561,1272,289
963,Sejong,2023,Total,119296,66130,53166
964,Sejong,2023,Under 30 years,1926,959,967
965,Sejong,2023,30-39 Years old,18889,10335,8554
966,Sejong,2023,40-49 Years old,38697,21788,16909
967,Sejong,2023,50-59 Years old,28982,16218,12764
968,Sejong,2023,60-69 Years old,18633,9834,8799
969,Sejong,2023,70-79 Years old,7539,4108,3431
970,Sejong,2023,80 years and over,3067,1612,1455
971,Sejong,2023,dead,1563,1276,287
972,Gyeonggi-do,2012,Total,2723040,1574029,1149011
973,Gyeonggi-do,2012,Under 30 years,65753,35235,30518
974,Gyeonggi-do,2012,30-39 Years old,503531,292361,211170
975,Gyeonggi-do,2012,40-49 Years old,813424,471653,341771
976,Gyeonggi-do,2012,50-59 Years old,690802,406513,284289
977,Gyeonggi-do,2012,60-69 Years old,366191,208100,158091
978,Gyeonggi-do,2012,70-79 Years old,211918,116478,95440
979,Gyeonggi-do,2012,80 years and over,44647,22986,21661
980,Gyeonggi-do,2012,dead,26774,20703,6071
981,Gyeonggi-do,2013,Total,2816567,1615124,1201443
982,Gyeonggi-do,2013,Under 30 years,59297,31809,27488
983,Gyeonggi-do,2013,30-39 Years old,486727,281969,204758
984,Gyeonggi-do,2013,40-49 Years old,834748,477979,356769
985,Gyeonggi-do,2013,50-59 Years old,737938,429215,308723
986,Gyeonggi-do,2013,60-69 Years old,387244,219433,167811
987,Gyeonggi-do,2013,70-79 Years old,230108,125915,104193
988,Gyeonggi-do,2013,80 years and over,52281,26877,25404
989,Gyeonggi-do,2013,dead,28224,21927,6297
990,Gyeonggi-do,2014,Total,2880735,1639115,1241620
991,Gyeonggi-do,2014,Under 30 years,56222,30106,26116
992,Gyeonggi-do,2014,30-39 Years old,474081,275964,198117
993,Gyeonggi-do,2014,40-49 Years old,851111,482304,368807
994,Gyeonggi-do,2014,50-59 Years old,764786,438104,326682
995,Gyeonggi-do,2014,60-69 Years old,406636,229417,177219
996,Gyeonggi-do,2014,70-79 Years old,239880,130238,109642
997,Gyeonggi-do,2014,80 years and over,58051,29612,28439
998,Gyeonggi-do,2014,dead,29968,23370,6598
999,Gyeonggi-do,2015,Total,2991332,1684388,1306944
1000,Gyeonggi-do,2015,Under 30 years,63488,33968,29520
1001,Gyeonggi-do,2015,30-39 Years old,476065,278319,197746
1002,Gyeonggi-do,2015,40-49 Years old,864535,484546,379989
1003,Gyeonggi-do,2015,50-59 Years old,795506,447214,348292
1004,Gyeonggi-do,2015,60-69 Years old,443792,247687,196105
1005,Gyeonggi-do,2015,70-79 Years old,251371,135648,115723
1006,Gyeonggi-do,2015,80 years and over,66941,33988,32953
1007,Gyeonggi-do,2015,dead,29634,23018,6616
1008,Gyeonggi-do,2016,Total,3069755,1714341,1355414
1009,Gyeonggi-do,2016,Under 30 years,59230,31778,27452
1010,Gyeonggi-do,2016,30-39 Years old,468382,274719,193663
1011,Gyeonggi-do,2016,40-49 Years old,871115,485429,385686
1012,Gyeonggi-do,2016,50-59 Years old,823191,455790,367401
1013,Gyeonggi-do,2016,60-69 Years old,476876,263034,213842
1014,Gyeonggi-do,2016,70-79 Years old,262385,140260,122125
1015,Gyeonggi-do,2016,80 years and over,77242,39010,38232
1016,Gyeonggi-do,2016,dead,31334,24321,7013
1017,Gyeonggi-do,2017,Total,3169606,1760672,1408934
1018,Gyeonggi-do,2017,Under 30 years,60698,32656,28042
1019,Gyeonggi-do,2017,30-39 Years old,465594,274381,191213
1020,Gyeonggi-do,2017,40-49 Years old,884609,493345,391264
1021,Gyeonggi-do,2017,50-59 Years old,850350,463564,386786
1022,Gyeonggi-do,2017,60-69 Years old,508833,278603,230230
1023,Gyeonggi-do,2017,70-79 Years old,280421,149268,131153
1024,Gyeonggi-do,2017,80 years and over,86868,43941,42927
1025,Gyeonggi-do,2017,dead,32233,24914,7319
1026,Gyeonggi-do,2018,Total,3307703,1823763,1483940
1027,Gyeonggi-do,2018,Under 30 years,63450,34062,29388
1028,Gyeonggi-do,2018,30-39 Years old,477730,281349,196381
1029,Gyeonggi-do,2018,40-49 Years old,897411,501193,396218
1030,Gyeonggi-do,2018,50-59 Years old,891234,478096,413138
1031,Gyeonggi-do,2018,60-69 Years old,549564,298135,251429
1032,Gyeonggi-do,2018,70-79 Years old,296854,156216,140638
1033,Gyeonggi-do,2018,80 years and over,98123,49323,48800
1034,Gyeonggi-do,2018,dead,33337,25389,7948
1035,Gyeonggi-do,2019,Total,3454042,1891708,1562334
1036,Gyeonggi-do,2019,Under 30 years,63548,33719,29829
1037,Gyeonggi-do,2019,30-39 Years old,480297,282760,197537
1038,Gyeonggi-do,2019,40-49 Years old,917841,514574,403267
1039,Gyeonggi-do,2019,50-59 Years old,934583,494963,439620
1040,Gyeonggi-do,2019,60-69 Years old,599783,321885,277898
1041,Gyeonggi-do,2019,70-79 Years old,313485,163221,150264
1042,Gyeonggi-do,2019,80 years and over,110996,55267,55729
1043,Gyeonggi-do,2019,dead,33509,25319,8190
1044,Gyeonggi-do,2020,Total,3587339,1949089,1638250
1045,Gyeonggi-do,2020,Under 30 years,69823,37199,32624
1046,Gyeonggi-do,2020,30-39 Years old,469018,274536,194482
1047,Gyeonggi-do,2020,40-49 Years old,934595,525139,409456
1048,Gyeonggi-do,2020,50-59 Years old,964462,505396,459066
1049,Gyeonggi-do,2020,60-69 Years old,662507,350987,311520
1050,Gyeonggi-do,2020,70-79 Years old,329929,170018,159911
1051,Gyeonggi-do,2020,80 years and over,123602,60839,62763
1052,Gyeonggi-do,2020,dead,33403,24975,8428
1053,Gyeonggi-do,2021,Total,3732021,2016017,1716004
1054,Gyeonggi-do,2021,Under 30 years,78637,42068,36569
1055,Gyeonggi-do,2021,30-39 Years old,466687,271092,195595
1056,Gyeonggi-do,2021,40-49 Years old,943905,533634,410271
1057,Gyeonggi-do,2021,50-59 Years old,994709,519227,475482
1058,Gyeonggi-do,2021,60-69 Years old,735621,384727,350894
1059,Gyeonggi-do,2021,70-79 Years old,340720,173635,167085
1060,Gyeonggi-do,2021,80 years and over,138360,67052,71308
1061,Gyeonggi-do,2021,dead,33382,24582,8800
1062,Gyeonggi-do,2022,Total,3815559,2054048,1761511
1063,Gyeonggi-do,2022,Under 30 years,73223,38906,34317
1064,Gyeonggi-do,2022,30-39 Years old,438874,253449,185425
1065,Gyeonggi-do,2022,40-49 Years old,946142,538007,408135
1066,Gyeonggi-do,2022,50-59 Years old,1023090,533944,489146
1067,Gyeonggi-do,2022,60-69 Years old,778984,404733,374251
1068,Gyeonggi-do,2022,70-79 Years old,361105,183132,177973
1069,Gyeonggi-do,2022,80 years and over,156804,74953,81851
1070,Gyeonggi-do,2022,dead,37337,26924,10413
1071,Gyeonggi-do,2023,Total,3944046,2117116,1826930
1072,Gyeonggi-do,2023,Under 30 years,67407,35752,31655
1073,Gyeonggi-do,2023,30-39 Years old,435774,250784,184990
1074,Gyeonggi-do,2023,40-49 Years old,955457,547332,408125
1075,Gyeonggi-do,2023,50-59 Years old,1058810,552486,506324
1076,Gyeonggi-do,2023,60-69 Years old,834396,430957,403439
1077,Gyeonggi-do,2023,70-79 Years old,383115,192808,190307
1078,Gyeonggi-do,2023,80 years and over,172445,80841,91604
1079,Gyeonggi-do,2023,dead,36642,26156,10486
1080,Gangwon State,2012,Total,361897,216477,145420
1081,Gangwon State,2012,Under 30 years,7545,4483,3062
1082,Gangwon State,2012,30-39 Years old,44883,25505,19378
1083,Gangwon State,2012,40-49 Years old,81527,46686,34841
1084,Gangwon State,2012,50-59 Years old,98347,58626,39721
1085,Gangwon State,2012,60-69 Years old,64147,38750,25397
1086,Gangwon State,2012,70-79 Years old,45341,27683,17658
1087,Gangwon State,2012,80 years and over,9844,5770,4074
1088,Gangwon State,2012,dead,10263,8974,1289
1089,Gangwon State,2013,Total,378828,224857,153971
1090,Gangwon State,2013,Under 30 years,6874,4143,2731
1091,Gangwon State,2013,30-39 Years old,43638,24872,18766
1092,Gangwon State,2013,40-49 Years old,83067,47110,35957
1093,Gangwon State,2013,50-59 Years old,103992,61257,42735
1094,Gangwon State,2013,60-69 Years old,68012,40633,27379
1095,Gangwon State,2013,70-79 Years old,50611,30487,20124
1096,Gangwon State,2013,80 years and over,11535,6647,4888
1097,Gangwon State,2013,dead,11099,9708,1391
1098,Gangwon State,2014,Total,384092,226414,157678
1099,Gangwon State,2014,Under 30 years,6469,3996,2473
1100,Gangwon State,2014,30-39 Years old,42167,24253,17914
1101,Gangwon State,2014,40-49 Years old,84058,47228,36830
1102,Gangwon State,2014,50-59 Years old,103694,60167,43527
1103,Gangwon State,2014,60-69 Years old,70346,41727,28619
1104,Gangwon State,2014,70-79 Years old,52489,31225,21264
1105,Gangwon State,2014,80 years and over,12139,6664,5475
1106,Gangwon State,2014,dead,12730,11154,1576
1107,Gangwon State,2015,Total,395250,229969,165281
1108,Gangwon State,2015,Under 30 years,8320,5080,3240
1109,Gangwon State,2015,30-39 Years old,43028,24928,18100
1110,Gangwon State,2015,40-49 Years old,85919,47861,38058
1111,Gangwon State,2015,50-59 Years old,104741,59500,45241
1112,Gangwon State,2015,60-69 Years old,74114,43328,30786
1113,Gangwon State,2015,70-79 Years old,53548,31473,22075
1114,Gangwon State,2015,80 years and over,13590,7341,6249
1115,Gangwon State,2015,dead,11990,10458,1532
1116,Gangwon State,2016,Total,407573,235437,172136
1117,Gangwon State,2016,Under 30 years,7127,4318,2809
1118,Gangwon State,2016,30-39 Years old,42430,24836,17594
1119,Gangwon State,2016,40-49 Years old,85640,47420,38220
1120,Gangwon State,2016,50-59 Years old,107049,59915,47134
1121,Gangwon State,2016,60-69 Years old,80489,46636,33853
1122,Gangwon State,2016,70-79 Years old,55933,32495,23438
1123,Gangwon State,2016,80 years and over,16097,8714,7383
1124,Gangwon State,2016,dead,12808,11103,1705
1125,Gangwon State,2017,Total,416492,239480,177012
1126,Gangwon State,2017,Under 30 years,7078,4270,2808
1127,Gangwon State,2017,30-39 Years old,40809,24112,16697
1128,Gangwon State,2017,40-49 Years old,85455,47214,38241
1129,Gangwon State,2017,50-59 Years old,107196,59107,48089
1130,Gangwon State,2017,60-69 Years old,86022,49631,36391
1131,Gangwon State,2017,70-79 Years old,58470,33765,24705
1132,Gangwon State,2017,80 years and over,18292,10006,8286
1133,Gangwon State,2017,dead,13170,11375,1795
1134,Gangwon State,2018,Total,426399,243015,183384
1135,Gangwon State,2018,Under 30 years,7172,4347,2825
1136,Gangwon State,2018,30-39 Years old,40290,23961,16329
1137,Gangwon State,2018,40-49 Years old,84496,46592,37904
1138,Gangwon State,2018,50-59 Years old,109058,59179,49879
1139,Gangwon State,2018,60-69 Years old,91602,52359,39243
1140,Gangwon State,2018,70-79 Years old,59911,34118,25793
1141,Gangwon State,2018,80 years and over,21177,11652,9525
1142,Gangwon State,2018,dead,12693,10807,1886
1143,Gangwon State,2019,Total,440683,248979,191704
1144,Gangwon State,2019,Under 30 years,7283,4362,2921
1145,Gangwon State,2019,30-39 Years old,40833,24402,16431
1146,Gangwon State,2019,40-49 Years old,85155,46874,38281
1147,Gangwon State,2019,50-59 Years old,111583,59812,51771
1148,Gangwon State,2019,60-69 Years old,98790,55681,43109
1149,Gangwon State,2019,70-79 Years old,60576,34143,26433
1150,Gangwon State,2019,80 years and over,23682,12921,10761
1151,Gangwon State,2019,dead,12781,10784,1997
1152,Gangwon State,2020,Total,459542,257233,202309
1153,Gangwon State,2020,Under 30 years,7724,4603,3121
1154,Gangwon State,2020,30-39 Years old,41717,25143,16574
1155,Gangwon State,2020,40-49 Years old,87067,47785,39282
1156,Gangwon State,2020,50-59 Years old,113661,60282,53379
1157,Gangwon State,2020,60-69 Years old,108743,60326,48417
1158,Gangwon State,2020,70-79 Years old,61333,34030,27303
1159,Gangwon State,2020,80 years and over,26458,14222,12236
1160,Gangwon State,2020,dead,12839,10842,1997
1161,Gangwon State,2021,Total,473451,262062,211389
1162,Gangwon State,2021,Under 30 years,8322,4933,3389
1163,Gangwon State,2021,30-39 Years old,41452,24791,16661
1164,Gangwon State,2021,40-49 Years old,87150,48000,39150
1165,Gangwon State,2021,50-59 Years old,114899,60339,54560
1166,Gangwon State,2021,60-69 Years old,119415,65291,54124
1167,Gangwon State,2021,70-79 Years old,61227,33410,27817
1168,Gangwon State,2021,80 years and over,28982,15351,13631
1169,Gangwon State,2021,dead,12004,9947,2057
1170,Gangwon State,2022,Total,484622,266033,218589
1171,Gangwon State,2022,Under 30 years,8125,4773,3352
1172,Gangwon State,2022,30-39 Years old,40067,23992,16075
1173,Gangwon State,2022,40-49 Years old,86981,47981,39000
1174,Gangwon State,2022,50-59 Years old,116590,60856,55734
1175,Gangwon State,2022,60-69 Years old,124057,66767,57290
1176,Gangwon State,2022,70-79 Years old,64660,35114,29546
1177,Gangwon State,2022,80 years and over,31959,16564,15395
1178,Gangwon State,2022,dead,12183,9986,2197
1179,Gangwon State,2023,Total,492745,268674,224071
1180,Gangwon State,2023,Under 30 years,7320,4228,3092
1181,Gangwon State,2023,30-39 Years old,38142,22966,15176
1182,Gangwon State,2023,40-49 Years old,85150,47225,37925
1183,Gangwon State,2023,50-59 Years old,117956,61466,56490
1184,Gangwon State,2023,60-69 Years old,130108,69250,60858
1185,Gangwon State,2023,70-79 Years old,67344,36155,31189
1186,Gangwon State,2023,80 years and over,34456,17461,16995
1187,Gangwon State,2023,dead,12269,9923,2346
1188,Chungcheongbuk-do,2012,Total,385708,237524,148184
1189,Chungcheongbuk-do,2012,Under 30 years,9237,5446,3791
1190,Chungcheongbuk-do,2012,30-39 Years old,59838,35564,24274
1191,Chungcheongbuk-do,2012,40-49 Years old,93530,54934,38596
1192,Chungcheongbuk-do,2012,50-59 Years old,98469,60011,38458
1193,Chungcheongbuk-do,2012,60-69 Years old,60288,37660,22628
1194,Chungcheongbuk-do,2012,70-79 Years old,42312,26690,15622
1195,Chungcheongbuk-do,2012,80 years and over,9693,6185,3508
1196,Chungcheongbuk-do,2012,dead,12341,11034,1307
1197,Chungcheongbuk-do,2013,Total,401423,244921,156502
1198,Chungcheongbuk-do,2013,Under 30 years,8394,4969,3425
1199,Chungcheongbuk-do,2013,30-39 Years old,59327,35361,23966
1200,Chungcheongbuk-do,2013,40-49 Years old,96704,55759,40945
1201,Chungcheongbuk-do,2013,50-59 Years old,103009,61856,41153
1202,Chungcheongbuk-do,2013,60-69 Years old,63556,39254,24302
1203,Chungcheongbuk-do,2013,70-79 Years old,45671,28516,17155
1204,Chungcheongbuk-do,2013,80 years and over,11346,7187,4159
1205,Chungcheongbuk-do,2013,dead,13416,12019,1397
1206,Chungcheongbuk-do,2014,Total,406834,245502,161332
1207,Chungcheongbuk-do,2014,Under 30 years,8117,4844,3273
1208,Chungcheongbuk-do,2014,30-39 Years old,57621,34581,23040
1209,Chungcheongbuk-do,2014,40-49 Years old,98636,56192,42444
1210,Chungcheongbuk-do,2014,50-59 Years old,103913,61213,42700
1211,Chungcheongbuk-do,2014,60-69 Years old,66236,40330,25906
1212,Chungcheongbuk-do,2014,70-79 Years old,45956,28094,17862
1213,Chungcheongbuk-do,2014,80 years and over,11274,6675,4599
1214,Chungcheongbuk-do,2014,dead,15081,13573,1508
1215,Chungcheongbuk-do,2015,Total,414536,246527,168009
1216,Chungcheongbuk-do,2015,Under 30 years,9364,5507,3857
1217,Chungcheongbuk-do,2015,30-39 Years old,57414,34702,22712
1218,Chungcheongbuk-do,2015,40-49 Years old,99532,56014,43518
1219,Chungcheongbuk-do,2015,50-59 Years old,106136,61083,45053
1220,Chungcheongbuk-do,2015,60-69 Years old,69810,41654,28156
1221,Chungcheongbuk-do,2015,70-79 Years old,45046,27066,17980
1222,Chungcheongbuk-do,2015,80 years and over,12453,7247,5206
1223,Chungcheongbuk-do,2015,dead,14781,13254,1527
1224,Chungcheongbuk-do,2016,Total,426272,251799,174473
1225,Chungcheongbuk-do,2016,Under 30 years,8154,4809,3345
1226,Chungcheongbuk-do,2016,30-39 Years old,55380,33740,21640
1227,Chungcheongbuk-do,2016,40-49 Years old,99235,55320,43915
1228,Chungcheongbuk-do,2016,50-59 Years old,109299,61925,47374
1229,Chungcheongbuk-do,2016,60-69 Years old,76707,45297,31410
1230,Chungcheongbuk-do,2016,70-79 Years old,46837,27909,18928
1231,Chungcheongbuk-do,2016,80 years and over,14734,8541,6193
1232,Chungcheongbuk-do,2016,dead,15926,14258,1668
1233,Chungcheongbuk-do,2017,Total,441796,259881,181915
1234,Chungcheongbuk-do,2017,Under 30 years,7929,4728,3201
1235,Chungcheongbuk-do,2017,30-39 Years old,53726,32964,20762
1236,Chungcheongbuk-do,2017,40-49 Years old,99499,55534,43965
1237,Chungcheongbuk-do,2017,50-59 Years old,112553,62952,49601
1238,Chungcheongbuk-do,2017,60-69 Years old,83781,49138,34643
1239,Chungcheongbuk-do,2017,70-79 Years old,50509,29912,20597
1240,Chungcheongbuk-do,2017,80 years and over,17219,9903,7316
1241,Chungcheongbuk-do,2017,dead,16580,14750,1830
1242,Chungcheongbuk-do,2018,Total,453048,264455,188593
1243,Chungcheongbuk-do,2018,Under 30 years,8448,5033,3415
1244,Chungcheongbuk-do,2018,30-39 Years old,53446,33129,20317
1245,Chungcheongbuk-do,2018,40-49 Years old,98949,55472,43477
1246,Chungcheongbuk-do,2018,50-59 Years old,115498,63364,52134
1247,Chungcheongbuk-do,2018,60-69 Years old,89050,51424,37626
1248,Chungcheongbuk-do,2018,70-79 Years old,52064,30552,21512
1249,Chungcheongbuk-do,2018,80 years and over,19846,11630,8216
1250,Chungcheongbuk-do,2018,dead,15747,13851,1896
1251,Chungcheongbuk-do,2019,Total,469366,272467,196899
1252,Chungcheongbuk-do,2019,Under 30 years,8596,5141,3455
1253,Chungcheongbuk-do,2019,30-39 Years old,53270,33178,20092
1254,Chungcheongbuk-do,2019,40-49 Years old,99145,55953,43192
1255,Chungcheongbuk-do,2019,50-59 Years old,120105,64977,55128
1256,Chungcheongbuk-do,2019,60-69 Years old,95320,54338,40982
1257,Chungcheongbuk-do,2019,70-79 Years old,54017,31371,22646
1258,Chungcheongbuk-do,2019,80 years and over,22319,12950,9369
1259,Chungcheongbuk-do,2019,dead,16594,14559,2035
1260,Chungcheongbuk-do,2020,Total,482771,277872,204899
1261,Chungcheongbuk-do,2020,Under 30 years,9023,5390,3633
1262,Chungcheongbuk-do,2020,30-39 Years old,52281,32620,19661
1263,Chungcheongbuk-do,2020,40-49 Years old,99825,56455,43370
1264,Chungcheongbuk-do,2020,50-59 Years old,121707,65266,56441
1265,Chungcheongbuk-do,2020,60-69 Years old,103199,57780,45419
1266,Chungcheongbuk-do,2020,70-79 Years old,55469,31745,23724
1267,Chungcheongbuk-do,2020,80 years and over,24319,13815,10504
1268,Chungcheongbuk-do,2020,dead,16948,14801,2147
1269,Chungcheongbuk-do,2021,Total,493366,281033,212333
1270,Chungcheongbuk-do,2021,Under 30 years,9427,5566,3861
1271,Chungcheongbuk-do,2021,30-39 Years old,50632,31642,18990
1272,Chungcheongbuk-do,2021,40-49 Years old,98494,55985,42509
1273,Chungcheongbuk-do,2021,50-59 Years old,121898,64540,57358
1274,Chungcheongbuk-do,2021,60-69 Years old,113736,62734,51002
1275,Chungcheongbuk-do,2021,70-79 Years old,56323,31675,24648
1276,Chungcheongbuk-do,2021,80 years and over,26626,14796,11830
1277,Chungcheongbuk-do,2021,dead,16230,14095,2135
1278,Chungcheongbuk-do,2022,Total,499702,283001,216701
1279,Chungcheongbuk-do,2022,Under 30 years,8834,5158,3676
1280,Chungcheongbuk-do,2022,30-39 Years old,47183,29741,17442
1281,Chungcheongbuk-do,2022,40-49 Years old,98013,56063,41950
1282,Chungcheongbuk-do,2022,50-59 Years old,122193,64349,57844
1283,Chungcheongbuk-do,2022,60-69 Years old,118519,64776,53743
1284,Chungcheongbuk-do,2022,70-79 Years old,59342,32952,26390
1285,Chungcheongbuk-do,2022,80 years and over,29426,16047,13379
1286,Chungcheongbuk-do,2022,dead,16192,13915,2277
1287,Chungcheongbuk-do,2023,Total,511649,288100,223549
1288,Chungcheongbuk-do,2023,Under 30 years,8448,4921,3527
1289,Chungcheongbuk-do,2023,30-39 Years old,46355,29397,16958
1290,Chungcheongbuk-do,2023,40-49 Years old,97472,56268,41204
1291,Chungcheongbuk-do,2023,50-59 Years old,125774,65878,59896
1292,Chungcheongbuk-do,2023,60-69 Years old,123909,66990,56919
1293,Chungcheongbuk-do,2023,70-79 Years old,62231,34183,28048
1294,Chungcheongbuk-do,2023,80 years and over,31366,16729,14637
1295,Chungcheongbuk-do,2023,dead,16094,13734,2360
1296,Chungcheongnam-do,2012,Total,476502,299319,177183
1297,Chungcheongnam-do,2012,Under 30 years,11168,6249,4919
1298,Chungcheongnam-do,2012,30-39 Years old,74652,45989,28663
1299,Chungcheongnam-do,2012,40-49 Years old,109195,65560,43635
1300,Chungcheongnam-do,2012,50-59 Years old,110639,68177,42462
1301,Chungcheongnam-do,2012,60-69 Years old,76934,48831,28103
1302,Chungcheongnam-do,2012,70-79 Years old,58976,37285,21691
1303,Chungcheongnam-do,2012,80 years and over,15490,9791,5699
1304,Chungcheongnam-do,2012,dead,19448,17437,2011
1305,Chungcheongnam-do,2013,Total,498651,312012,186639
1306,Chungcheongnam-do,2013,Under 30 years,10145,5727,4418
1307,Chungcheongnam-do,2013,30-39 Years old,73508,45464,28044
1308,Chungcheongnam-do,2013,40-49 Years old,112831,67108,45723
1309,Chungcheongnam-do,2013,50-59 Years old,117645,71783,45862
1310,Chungcheongnam-do,2013,60-69 Years old,80990,51050,29940
1311,Chungcheongnam-do,2013,70-79 Years old,63375,39789,23586
1312,Chungcheongnam-do,2013,80 years and over,18701,11844,6857
1313,Chungcheongnam-do,2013,dead,21456,19247,2209
1314,Chungcheongnam-do,2014,Total,520719,322316,198403
1315,Chungcheongnam-do,2014,Under 30 years,11085,6147,4938
1316,Chungcheongnam-do,2014,30-39 Years old,77567,48543,29024
1317,Chungcheongnam-do,2014,40-49 Years old,118609,69807,48802
1318,Chungcheongnam-do,2014,50-59 Years old,120549,72131,48418
1319,Chungcheongnam-do,2014,60-69 Years old,84480,52511,31969
1320,Chungcheongnam-do,2014,70-79 Years old,64944,39984,24960
1321,Chungcheongnam-do,2014,80 years and over,19922,12094,7828
1322,Chungcheongnam-do,2014,dead,23563,21099,2464
1323,Chungcheongnam-do,2015,Total,533423,325831,207592
1324,Chungcheongnam-do,2015,Under 30 years,13150,7263,5887
1325,Chungcheongnam-do,2015,30-39 Years old,78218,49313,28905
1326,Chungcheongnam-do,2015,40-49 Years old,121537,70906,50631
1327,Chungcheongnam-do,2015,50-59 Years old,123915,72736,51179
1328,Chungcheongnam-do,2015,60-69 Years old,89743,54816,34927
1329,Chungcheongnam-do,2015,70-79 Years old,62858,37999,24859
1330,Chungcheongnam-do,2015,80 years and over,21339,12619,8720
1331,Chungcheongnam-do,2015,dead,22663,20179,2484
1332,Chungcheongnam-do,2016,Total,555471,337002,218469
1333,Chungcheongnam-do,2016,Under 30 years,12596,6995,5601
1334,Chungcheongnam-do,2016,30-39 Years old,81183,51656,29527
1335,Chungcheongnam-do,2016,40-49 Years old,125669,72959,52710
1336,Chungcheongnam-do,2016,50-59 Years old,127612,73452,54160
1337,Chungcheongnam-do,2016,60-69 Years old,96867,58316,38551
1338,Chungcheongnam-do,2016,70-79 Years old,63410,38078,25332
1339,Chungcheongnam-do,2016,80 years and over,24300,14325,9975
1340,Chungcheongnam-do,2016,dead,23834,21221,2613
1341,Chungcheongnam-do,2017,Total,583830,353700,230130
1342,Chungcheongnam-do,2017,Under 30 years,12211,6908,5303
1343,Chungcheongnam-do,2017,30-39 Years old,81758,52178,29580
1344,Chungcheongnam-do,2017,40-49 Years old,129937,75622,54315
1345,Chungcheongnam-do,2017,50-59 Years old,133135,75901,57234
1346,Chungcheongnam-do,2017,60-69 Years old,104125,62414,41711
1347,Chungcheongnam-do,2017,70-79 Years old,69053,41756,27297
1348,Chungcheongnam-do,2017,80 years and over,28819,16934,11885
1349,Chungcheongnam-do,2017,dead,24792,21987,2805
1350,Chungcheongnam-do,2018,Total,604516,362834,241682
1351,Chungcheongnam-do,2018,Under 30 years,12327,7030,5297
1352,Chungcheongnam-do,2018,30-39 Years old,82991,53006,29985
1353,Chungcheongnam-do,2018,40-49 Years old,132395,77372,55023
1354,Chungcheongnam-do,2018,50-59 Years old,139334,78028,61306
1355,Chungcheongnam-do,2018,60-69 Years old,109384,64395,44989
1356,Chungcheongnam-do,2018,70-79 Years old,71518,42822,28696
1357,Chungcheongnam-do,2018,80 years and over,32606,19168,13438
1358,Chungcheongnam-do,2018,dead,23961,21013,2948
1359,Chungcheongnam-do,2019,Total,620151,369603,250548
1360,Chungcheongnam-do,2019,Under 30 years,11941,6776,5165
1361,Chungcheongnam-do,2019,30-39 Years old,81142,51879,29263
1362,Chungcheongnam-do,2019,40-49 Years old,134434,79089,55345
1363,Chungcheongnam-do,2019,50-59 Years old,144477,80032,64445
1364,Chungcheongnam-do,2019,60-69 Years old,114915,66495,48420
1365,Chungcheongnam-do,2019,70-79 Years old,73926,43909,30017
1366,Chungcheongnam-do,2019,80 years and over,35399,20503,14896
1367,Chungcheongnam-do,2019,dead,23917,20920,2997
1368,Chungcheongnam-do,2020,Total,634615,375441,259174
1369,Chungcheongnam-do,2020,Under 30 years,11804,6651,5153
1370,Chungcheongnam-do,2020,30-39 Years old,76220,48674,27546
1371,Chungcheongnam-do,2020,40-49 Years old,136126,80608,55518
1372,Chungcheongnam-do,2020,50-59 Years old,146755,80774,65981
1373,Chungcheongnam-do,2020,60-69 Years old,124144,70659,53485
1374,Chungcheongnam-do,2020,70-79 Years old,77481,45595,31886
1375,Chungcheongnam-do,2020,80 years and over,38008,21576,16432
1376,Chungcheongnam-do,2020,dead,24077,20904,3173
1377,Chungcheongnam-do,2021,Total,646326,379276,267050
1378,Chungcheongnam-do,2021,Under 30 years,12227,6886,5341
1379,Chungcheongnam-do,2021,30-39 Years old,71449,45440,26009
1380,Chungcheongnam-do,2021,40-49 Years old,135863,80955,54908
1381,Chungcheongnam-do,2021,50-59 Years old,148831,81157,67674
1382,Chungcheongnam-do,2021,60-69 Years old,135131,75702,59429
1383,Chungcheongnam-do,2021,70-79 Years old,78814,45860,32954
1384,Chungcheongnam-do,2021,80 years and over,39809,22333,17476
1385,Chungcheongnam-do,2021,dead,24202,20943,3259
1386,Chungcheongnam-do,2022,Total,654084,380654,273430
1387,Chungcheongnam-do,2022,Under 30 years,11383,6418,4965
1388,Chungcheongnam-do,2022,30-39 Years old,66061,41521,24540
1389,Chungcheongnam-do,2022,40-49 Years old,136839,81983,54856
1390,Chungcheongnam-do,2022,50-59 Years old,151587,82299,69288
1391,Chungcheongnam-do,2022,60-69 Years old,141276,77937,63339
1392,Chungcheongnam-do,2022,70-79 Years old,79965,45912,34053
1393,Chungcheongnam-do,2022,80 years and over,42304,23343,18961
1394,Chungcheongnam-do,2022,dead,24669,21241,3428
1395,Chungcheongnam-do,2023,Total,672089,388025,284064
1396,Chungcheongnam-do,2023,Under 30 years,10598,6042,4556
1397,Chungcheongnam-do,2023,30-39 Years old,63598,39664,23934
1398,Chungcheongnam-do,2023,40-49 Years old,137452,82883,54569
1399,Chungcheongnam-do,2023,50-59 Years old,157558,85237,72321
1400,Chungcheongnam-do,2023,60-69 Years old,149798,81575,68223
1401,Chungcheongnam-do,2023,70-79 Years old,83290,47166,36124
1402,Chungcheongnam-do,2023,80 years and over,44704,24013,20691
1403,Chungcheongnam-do,2023,dead,25091,21445,3646
1404,Jeollabuk-do,2012,Total,464225,277419,186806
1405,Jeollabuk-do,2012,Under 30 years,10317,6060,4257
1406,Jeollabuk-do,2012,30-39 Years old,62149,35732,26417
1407,Jeollabuk-do,2012,40-49 Years old,102430,56888,45542
1408,Jeollabuk-do,2012,50-59 Years old,108315,62900,45415
1409,Jeollabuk-do,2012,60-69 Years old,81598,50001,31597
1410,Jeollabuk-do,2012,70-79 Years old,60397,36212,24185
1411,Jeollabuk-do,2012,80 years and over,16327,9826,6501
1412,Jeollabuk-do,2012,dead,22692,19800,2892
1413,Jeollabuk-do,2013,Total,483582,286816,196766
1414,Jeollabuk-do,2013,Under 30 years,9306,5482,3824
1415,Jeollabuk-do,2013,30-39 Years old,60409,35106,25303
1416,Jeollabuk-do,2013,40-49 Years old,105950,58324,47626
1417,Jeollabuk-do,2013,50-59 Years old,114456,65382,49074
1418,Jeollabuk-do,2013,60-69 Years old,85266,51678,33588
1419,Jeollabuk-do,2013,70-79 Years old,64973,38587,26386
1420,Jeollabuk-do,2013,80 years and over,19193,11306,7887
1421,Jeollabuk-do,2013,dead,24029,20951,3078
1422,Jeollabuk-do,2014,Total,488326,286915,201411
1423,Jeollabuk-do,2014,Under 30 years,8618,5070,3548
1424,Jeollabuk-do,2014,30-39 Years old,57620,33755,23865
1425,Jeollabuk-do,2014,40-49 Years old,108582,59356,49226
1426,Jeollabuk-do,2014,50-59 Years old,115409,64774,50635
1427,Jeollabuk-do,2014,60-69 Years old,87724,52467,35257
1428,Jeollabuk-do,2014,70-79 Years old,65156,38236,26920
1429,Jeollabuk-do,2014,80 years and over,19717,11019,8698
1430,Jeollabuk-do,2014,dead,25500,22238,3262
1431,Jeollabuk-do,2015,Total,500617,289859,210758
1432,Jeollabuk-do,2015,Under 30 years,10981,6319,4662
1433,Jeollabuk-do,2015,30-39 Years old,58855,34643,24212
1434,Jeollabuk-do,2015,40-49 Years old,111042,60140,50902
1435,Jeollabuk-do,2015,50-59 Years old,117697,64527,53170
1436,Jeollabuk-do,2015,60-69 Years old,92572,54292,38280
1437,Jeollabuk-do,2015,70-79 Years old,63522,36787,26735
1438,Jeollabuk-do,2015,80 years and over,21145,11607,9538
1439,Jeollabuk-do,2015,dead,24803,21544,3259
1440,Jeollabuk-do,2016,Total,503407,290112,213295
1441,Jeollabuk-do,2016,Under 30 years,9018,5252,3766
1442,Jeollabuk-do,2016,30-39 Years old,56093,33360,22733
1443,Jeollabuk-do,2016,40-49 Years old,109665,59190,50475
1444,Jeollabuk-do,2016,50-59 Years old,118757,64200,54557
1445,Jeollabuk-do,2016,60-69 Years old,96008,55484,40524
1446,Jeollabuk-do,2016,70-79 Years old,64299,37151,27148
1447,Jeollabuk-do,2016,80 years and over,23476,12840,10636
1448,Jeollabuk-do,2016,dead,26091,22635,3456
1449,Jeollabuk-do,2017,Total,519633,298674,220959
1450,Jeollabuk-do,2017,Under 30 years,8694,5074,3620
1451,Jeollabuk-do,2017,30-39 Years old,53677,32256,21421
1452,Jeollabuk-do,2017,40-49 Years old,109347,59322,50025
1453,Jeollabuk-do,2017,50-59 Years old,121451,64950,56501
1454,Jeollabuk-do,2017,60-69 Years old,100860,57802,43058
1455,Jeollabuk-do,2017,70-79 Years old,70958,40943,30015
1456,Jeollabuk-do,2017,80 years and over,27654,15114,12540
1457,Jeollabuk-do,2017,dead,26992,23213,3779
1458,Jeollabuk-do,2018,Total,529293,301871,227422
1459,Jeollabuk-do,2018,Under 30 years,8626,4974,3652
1460,Jeollabuk-do,2018,30-39 Years old,52814,31978,20836
1461,Jeollabuk-do,2018,40-49 Years old,107980,58686,49294
1462,Jeollabuk-do,2018,50-59 Years old,125021,65982,59039
1463,Jeollabuk-do,2018,60-69 Years old,103886,58651,45235
1464,Jeollabuk-do,2018,70-79 Years old,73373,41924,31449
1465,Jeollabuk-do,2018,80 years and over,31180,17192,13988
1466,Jeollabuk-do,2018,dead,26413,22484,3929
1467,Jeollabuk-do,2019,Total,536922,303896,233026
1468,Jeollabuk-do,2019,Under 30 years,8246,4737,3509
1469,Jeollabuk-do,2019,30-39 Years old,50317,30487,19830
1470,Jeollabuk-do,2019,40-49 Years old,106716,58298,48418
1471,Jeollabuk-do,2019,50-59 Years old,127178,66537,60641
1472,Jeollabuk-do,2019,60-69 Years old,108256,60185,48071
1473,Jeollabuk-do,2019,70-79 Years old,75294,42440,32854
1474,Jeollabuk-do,2019,80 years and over,34076,18515,15561
1475,Jeollabuk-do,2019,dead,26839,22697,4142
1476,Jeollabuk-do,2020,Total,548245,307511,240734
1477,Jeollabuk-do,2020,Under 30 years,8286,4710,3576
1478,Jeollabuk-do,2020,30-39 Years old,48116,28996,19120
1479,Jeollabuk-do,2020,40-49 Years old,106848,58575,48273
1480,Jeollabuk-do,2020,50-59 Years old,127871,66498,61373
1481,Jeollabuk-do,2020,60-69 Years old,114726,62543,52183
1482,Jeollabuk-do,2020,70-79 Years old,78863,44061,34802
1483,Jeollabuk-do,2020,80 years and over,36656,19543,17113
1484,Jeollabuk-do,2020,dead,26879,22585,4294
1485,Jeollabuk-do,2021,Total,557185,308512,248673
1486,Jeollabuk-do,2021,Under 30 years,8900,5048,3852
1487,Jeollabuk-do,2021,30-39 Years old,46259,27677,18582
1488,Jeollabuk-do,2021,40-49 Years old,104716,57684,47032
1489,Jeollabuk-do,2021,50-59 Years old,130307,67123,63184
1490,Jeollabuk-do,2021,60-69 Years old,121920,64959,56961
1491,Jeollabuk-do,2021,70-79 Years old,80590,44313,36277
1492,Jeollabuk-do,2021,80 years and over,39022,20487,18535
1493,Jeollabuk-do,2021,dead,25471,21221,4250
1494,Jeollabuk-do,2022,Total,555750,305758,249992
1495,Jeollabuk-do,2022,Under 30 years,8074,4661,3413
1496,Jeollabuk-do,2022,30-39 Years old,41578,24832,16746
1497,Jeollabuk-do,2022,40-49 Years old,101887,56397,45490
1498,Jeollabuk-do,2022,50-59 Years old,131176,67344,63832
1499,Jeollabuk-do,2022,60-69 Years old,125213,65817,59396
1500,Jeollabuk-do,2022,70-79 Years old,79341,43222,36119
1501,Jeollabuk-do,2022,80 years and over,42482,22038,20444
1502,Jeollabuk-do,2022,dead,25999,21447,4552
1503,Jeollabuk-do,2023,Total,566305,308795,257510
1504,Jeollabuk-do,2023,Under 30 years,7956,4584,3372
1505,Jeollabuk-do,2023,30-39 Years old,40265,23892,16373
1506,Jeollabuk-do,2023,40-49 Years old,99745,55644,44101
1507,Jeollabuk-do,2023,50-59 Years old,134792,69048,65744
1508,Jeollabuk-do,2023,60-69 Years old,131490,68227,63263
1509,Jeollabuk-do,2023,70-79 Years old,81436,43674,37762
1510,Jeollabuk-do,2023,80 years and over,44864,22612,22252
1511,Jeollabuk-do,2023,dead,25757,21114,4643
1512,Jeollanam-do,2012,Total,485341,308167,177174
1513,Jeollanam-do,2012,Under 30 years,9548,5731,3817
1514,Jeollanam-do,2012,30-39 Years old,52460,30731,21729
1515,Jeollanam-do,2012,40-49 Years old,93942,55318,38624
1516,Jeollanam-do,2012,50-59 Years old,107666,66343,41323
1517,Jeollanam-do,2012,60-69 Years old,88642,57061,31581
1518,Jeollanam-do,2012,70-79 Years old,72195,44783,27412
1519,Jeollanam-do,2012,80 years and over,20513,12456,8057
1520,Jeollanam-do,2012,dead,40375,35744,4631
1521,Jeollanam-do,2013,Total,504612,318047,186565
1522,Jeollanam-do,2013,Under 30 years,8543,5088,3455
1523,Jeollanam-do,2013,30-39 Years old,51819,30651,21168
1524,Jeollanam-do,2013,40-49 Years old,95813,55519,40294
1525,Jeollanam-do,2013,50-59 Years old,113934,69159,44775
1526,Jeollanam-do,2013,60-69 Years old,91163,58157,33006
1527,Jeollanam-do,2013,70-79 Years old,77127,47572,29555
1528,Jeollanam-do,2013,80 years and over,23607,14145,9462
1529,Jeollanam-do,2013,dead,42606,37756,4850
1530,Jeollanam-do,2014,Total,502584,312050,190534
1531,Jeollanam-do,2014,Under 30 years,7775,4667,3108
1532,Jeollanam-do,2014,30-39 Years old,50582,29912,20670
1533,Jeollanam-do,2014,40-49 Years old,95070,54027,41043
1534,Jeollanam-do,2014,50-59 Years old,113180,66942,46238
1535,Jeollanam-do,2014,60-69 Years old,91230,57156,34074
1536,Jeollanam-do,2014,70-79 Years old,76396,46246,30150
1537,Jeollanam-do,2014,80 years and over,23060,12999,10061
1538,Jeollanam-do,2014,dead,45291,40101,5190
1539,Jeollanam-do,2015,Total,512148,313062,199086
1540,Jeollanam-do,2015,Under 30 years,11058,6366,4692
1541,Jeollanam-do,2015,30-39 Years old,52894,31520,21374
1542,Jeollanam-do,2015,40-49 Years old,97033,54575,42458
1543,Jeollanam-do,2015,50-59 Years old,115554,66769,48785
1544,Jeollanam-do,2015,60-69 Years old,93654,57670,35984
1545,Jeollanam-do,2015,70-79 Years old,73515,43761,29754
1546,Jeollanam-do,2015,80 years and over,24013,13228,10785
1547,Jeollanam-do,2015,dead,44427,39173,5254
1548,Jeollanam-do,2016,Total,518670,315245,203425
1549,Jeollanam-do,2016,Under 30 years,9068,5365,3703
1550,Jeollanam-do,2016,30-39 Years old,52110,31381,20729
1551,Jeollanam-do,2016,40-49 Years old,95544,53270,42274
1552,Jeollanam-do,2016,50-59 Years old,117981,67190,50791
1553,Jeollanam-do,2016,60-69 Years old,97239,59023,38216
1554,Jeollanam-do,2016,70-79 Years old,74589,44187,30402
1555,Jeollanam-do,2016,80 years and over,26171,14427,11744
1556,Jeollanam-do,2016,dead,45968,40402,5566
1557,Jeollanam-do,2017,Total,537573,326020,211553
1558,Jeollanam-do,2017,Under 30 years,8217,4900,3317
1559,Jeollanam-do,2017,30-39 Years old,50749,31154,19595
1560,Jeollanam-do,2017,40-49 Years old,95284,53181,42103
1561,Jeollanam-do,2017,50-59 Years old,120746,68503,52243
1562,Jeollanam-do,2017,60-69 Years old,102882,61899,40983
1563,Jeollanam-do,2017,70-79 Years old,81358,48064,33294
1564,Jeollanam-do,2017,80 years and over,30879,16841,14038
1565,Jeollanam-do,2017,dead,47458,41478,5980
1566,Jeollanam-do,2018,Total,546595,328904,217691
1567,Jeollanam-do,2018,Under 30 years,8876,5268,3608
1568,Jeollanam-do,2018,30-39 Years old,51177,31575,19602
1569,Jeollanam-do,2018,40-49 Years old,94824,53060,41764
1570,Jeollanam-do,2018,50-59 Years old,123374,68935,54439
1571,Jeollanam-do,2018,60-69 Years old,106012,62798,43214
1572,Jeollanam-do,2018,70-79 Years old,81978,48255,33723
1573,Jeollanam-do,2018,80 years and over,35179,19885,15294
1574,Jeollanam-do,2018,dead,45175,39128,6047
1575,Jeollanam-do,2019,Total,558332,333548,224784
1576,Jeollanam-do,2019,Under 30 years,8677,5160,3517
1577,Jeollanam-do,2019,30-39 Years old,49466,30835,18631
1578,Jeollanam-do,2019,40-49 Years old,94357,53033,41324
1579,Jeollanam-do,2019,50-59 Years old,125692,69608,56084
1580,Jeollanam-do,2019,60-69 Years old,111490,64874,46616
1581,Jeollanam-do,2019,70-79 Years old,84668,49460,35208
1582,Jeollanam-do,2019,80 years and over,38892,21675,17217
1583,Jeollanam-do,2019,dead,45090,38903,6187
1584,Jeollanam-do,2020,Total,574476,340186,234290
1585,Jeollanam-do,2020,Under 30 years,9071,5407,3664
1586,Jeollanam-do,2020,30-39 Years old,48782,30644,18138
1587,Jeollanam-do,2020,40-49 Years old,96939,54820,42119
1588,Jeollanam-do,2020,50-59 Years old,127256,69919,57337
1589,Jeollanam-do,2020,60-69 Years old,119242,68196,51046
1590,Jeollanam-do,2020,70-79 Years old,86739,50117,36622
1591,Jeollanam-do,2020,80 years and over,42274,23060,19214
1592,Jeollanam-do,2020,dead,44173,38023,6150
1593,Jeollanam-do,2021,Total,588595,344365,244230
1594,Jeollanam-do,2021,Under 30 years,9554,5654,3900
1595,Jeollanam-do,2021,30-39 Years old,48197,30103,18094
1596,Jeollanam-do,2021,40-49 Years old,97769,55386,42383
1597,Jeollanam-do,2021,50-59 Years old,130447,71216,59231
1598,Jeollanam-do,2021,60-69 Years old,127182,71290,55892
1599,Jeollanam-do,2021,70-79 Years old,87547,50075,37472
1600,Jeollanam-do,2021,80 years and over,45397,24355,21042
1601,Jeollanam-do,2021,dead,42502,36286,6216
1602,Jeollanam-do,2022,Total,593542,344876,248666
1603,Jeollanam-do,2022,Under 30 years,9164,5460,3704
1604,Jeollanam-do,2022,30-39 Years old,45240,28342,16898
1605,Jeollanam-do,2022,40-49 Years old,97255,55490,41765
1606,Jeollanam-do,2022,50-59 Years old,132266,71760,60506
1607,Jeollanam-do,2022,60-69 Years old,131961,73074,58887
1608,Jeollanam-do,2022,70-79 Years old,87070,49425,37645
1609,Jeollanam-do,2022,80 years and over,48403,25566,22837
1610,Jeollanam-do,2022,dead,42183,35759,6424
1611,Jeollanam-do,2023,Total,605006,348948,256058
1612,Jeollanam-do,2023,Under 30 years,8817,5190,3627
1613,Jeollanam-do,2023,30-39 Years old,43741,27448,16293
1614,Jeollanam-do,2023,40-49 Years old,96619,55766,40853
1615,Jeollanam-do,2023,50-59 Years old,134662,72748,61914
1616,Jeollanam-do,2023,60-69 Years old,139864,76726,63138
1617,Jeollanam-do,2023,70-79 Years old,89105,49974,39131
1618,Jeollanam-do,2023,80 years and over,51001,26368,24633
1619,Jeollanam-do,2023,dead,41197,34728,6469
1620,Gyeongsangbuk-do,2012,Total,696431,449409,247022
1621,Gyeongsangbuk-do,2012,Under 30 years,13710,7906,5804
1622,Gyeongsangbuk-do,2012,30-39 Years old,89291,54274,35017
1623,Gyeongsangbuk-do,2012,40-49 Years old,149496,92555,56941
1624,Gyeongsangbuk-do,2012,50-59 Years old,173222,110319,62903
1625,Gyeongsangbuk-do,2012,60-69 Years old,120113,77973,42140
1626,Gyeongsangbuk-do,2012,70-79 Years old,85609,54304,31305
1627,Gyeongsangbuk-do,2012,80 years and over,23096,14674,8422
1628,Gyeongsangbuk-do,2012,dead,41894,37404,4490
1629,Gyeongsangbuk-do,2013,Total,720722,461502,259220
1630,Gyeongsangbuk-do,2013,Under 30 years,12715,7446,5269
1631,Gyeongsangbuk-do,2013,30-39 Years old,87221,53174,34047
1632,Gyeongsangbuk-do,2013,40-49 Years old,150037,91079,58958
1633,Gyeongsangbuk-do,2013,50-59 Years old,179732,112676,67056
1634,Gyeongsangbuk-do,2013,60-69 Years old,126258,81328,44930
1635,Gyeongsangbuk-do,2013,70-79 Years old,92912,58549,34363
1636,Gyeongsangbuk-do,2013,80 years and over,26723,16956,9767
1637,Gyeongsangbuk-do,2013,dead,45124,40294,4830
1638,Gyeongsangbuk-do,2014,Total,720710,456203,264507
1639,Gyeongsangbuk-do,2014,Under 30 years,11945,7082,4863
1640,Gyeongsangbuk-do,2014,30-39 Years old,83613,51432,32181
1641,Gyeongsangbuk-do,2014,40-49 Years old,149182,88718,60464
1642,Gyeongsangbuk-do,2014,50-59 Years old,179135,109996,69139
1643,Gyeongsangbuk-do,2014,60-69 Years old,128938,81876,47062
1644,Gyeongsangbuk-do,2014,70-79 Years old,92421,57275,35146
1645,Gyeongsangbuk-do,2014,80 years and over,25676,15341,10335
1646,Gyeongsangbuk-do,2014,dead,49800,44483,5317
1647,Gyeongsangbuk-do,2015,Total,754879,470751,284128
1648,Gyeongsangbuk-do,2015,Under 30 years,15591,9005,6586
1649,Gyeongsangbuk-do,2015,30-39 Years old,86912,53910,33002
1650,Gyeongsangbuk-do,2015,40-49 Years old,154158,90595,63563
1651,Gyeongsangbuk-do,2015,50-59 Years old,185330,111685,73645
1652,Gyeongsangbuk-do,2015,60-69 Years old,140527,87955,52572
1653,Gyeongsangbuk-do,2015,70-79 Years old,93846,56944,36902
1654,Gyeongsangbuk-do,2015,80 years and over,29491,17065,12426
1655,Gyeongsangbuk-do,2015,dead,49024,43592,5432
1656,Gyeongsangbuk-do,2016,Total,770564,477110,293454
1657,Gyeongsangbuk-do,2016,Under 30 years,13667,7978,5689
1658,Gyeongsangbuk-do,2016,30-39 Years old,87788,54975,32813
1659,Gyeongsangbuk-do,2016,40-49 Years old,154273,89439,64834
1660,Gyeongsangbuk-do,2016,50-59 Years old,187750,111578,76172
1661,Gyeongsangbuk-do,2016,60-69 Years old,150332,92772,57560
1662,Gyeongsangbuk-do,2016,70-79 Years old,92825,55993,36832
1663,Gyeongsangbuk-do,2016,80 years and over,32650,18909,13741
1664,Gyeongsangbuk-do,2016,dead,51279,45466,5813
1665,Gyeongsangbuk-do,2017,Total,798792,491448,307344
1666,Gyeongsangbuk-do,2017,Under 30 years,13212,7857,5355
1667,Gyeongsangbuk-do,2017,30-39 Years old,87517,55131,32386
1668,Gyeongsangbuk-do,2017,40-49 Years old,156470,90228,66242
1669,Gyeongsangbuk-do,2017,50-59 Years old,191843,112337,79506
1670,Gyeongsangbuk-do,2017,60-69 Years old,160890,98521,62369
1671,Gyeongsangbuk-do,2017,70-79 Years old,99684,59923,39761
1672,Gyeongsangbuk-do,2017,80 years and over,36989,21378,15611
1673,Gyeongsangbuk-do,2017,dead,52187,46073,6114
1674,Gyeongsangbuk-do,2018,Total,818928,499090,319838
1675,Gyeongsangbuk-do,2018,Under 30 years,12907,7605,5302
1676,Gyeongsangbuk-do,2018,30-39 Years old,87238,55235,32003
1677,Gyeongsangbuk-do,2018,40-49 Years old,156337,89937,66400
1678,Gyeongsangbuk-do,2018,50-59 Years old,198051,113906,84145
1679,Gyeongsangbuk-do,2018,60-69 Years old,167607,101151,66456
1680,Gyeongsangbuk-do,2018,70-79 Years old,103977,62292,41685
1681,Gyeongsangbuk-do,2018,80 years and over,42983,25447,17536
1682,Gyeongsangbuk-do,2018,dead,49828,43517,6311
1683,Gyeongsangbuk-do,2019,Total,832387,503007,329380
1684,Gyeongsangbuk-do,2019,Under 30 years,12194,7121,5073
1685,Gyeongsangbuk-do,2019,30-39 Years old,83837,53285,30552
1686,Gyeongsangbuk-do,2019,40-49 Years old,155698,89642,66056
1687,Gyeongsangbuk-do,2019,50-59 Years old,201332,114360,86972
1688,Gyeongsangbuk-do,2019,60-69 Years old,175249,103972,71277
1689,Gyeongsangbuk-do,2019,70-79 Years old,107636,64131,43505
1690,Gyeongsangbuk-do,2019,80 years and over,46782,27259,19523
1691,Gyeongsangbuk-do,2019,dead,49659,43237,6422
1692,Gyeongsangbuk-do,2020,Total,847610,507692,339918
1693,Gyeongsangbuk-do,2020,Under 30 years,12250,7169,5081
1694,Gyeongsangbuk-do,2020,30-39 Years old,78950,50239,28711
1695,Gyeongsangbuk-do,2020,40-49 Years old,155532,89890,65642
1696,Gyeongsangbuk-do,2020,50-59 Years old,201438,113052,88386
1697,Gyeongsangbuk-do,2020,60-69 Years old,187697,109411,78286
1698,Gyeongsangbuk-do,2020,70-79 Years old,111252,65631,45621
1699,Gyeongsangbuk-do,2020,80 years and over,50460,28865,21595
1700,Gyeongsangbuk-do,2020,dead,50031,43435,6596
1701,Gyeongsangbuk-do,2021,Total,868281,513841,354440
1702,Gyeongsangbuk-do,2021,Under 30 years,13244,7723,5521
1703,Gyeongsangbuk-do,2021,30-39 Years old,76871,48773,28098
1704,Gyeongsangbuk-do,2021,40-49 Years old,156048,90423,65625
1705,Gyeongsangbuk-do,2021,50-59 Years old,202908,112187,90721
1706,Gyeongsangbuk-do,2021,60-69 Years old,202150,115871,86279
1707,Gyeongsangbuk-do,2021,70-79 Years old,114576,66827,47749
1708,Gyeongsangbuk-do,2021,80 years and over,54105,30296,23809
1709,Gyeongsangbuk-do,2021,dead,48379,41741,6638
1710,Gyeongsangbuk-do,2022,Total,873702,513569,360133
1711,Gyeongsangbuk-do,2022,Under 30 years,11804,6893,4911
1712,Gyeongsangbuk-do,2022,30-39 Years old,69455,44070,25385
1713,Gyeongsangbuk-do,2022,40-49 Years old,153371,89466,63905
1714,Gyeongsangbuk-do,2022,50-59 Years old,202739,111241,91498
1715,Gyeongsangbuk-do,2022,60-69 Years old,208992,118717,90275
1716,Gyeongsangbuk-do,2022,70-79 Years old,118799,68409,50390
1717,Gyeongsangbuk-do,2022,80 years and over,59041,32511,26530
1718,Gyeongsangbuk-do,2022,dead,49501,42262,7239
1719,Gyeongsangbuk-do,2023,Total,876159,510938,365221
1720,Gyeongsangbuk-do,2023,Under 30 years,11001,6425,4576
1721,Gyeongsangbuk-do,2023,30-39 Years old,64278,40901,23377
1722,Gyeongsangbuk-do,2023,40-49 Years old,149687,88011,61676
1723,Gyeongsangbuk-do,2023,50-59 Years old,202913,110411,92502
1724,Gyeongsangbuk-do,2023,60-69 Years old,214778,120564,94214
1725,Gyeongsangbuk-do,2023,70-79 Years old,122548,69907,52641
1726,Gyeongsangbuk-do,2023,80 years and over,62445,33456,28989
1727,Gyeongsangbuk-do,2023,dead,48509,41263,7246
1728,Gyeongsangnam-do,2012,Total,848060,512920,335140
1729,Gyeongsangnam-do,2012,Under 30 years,18896,11066,7830
1730,Gyeongsangnam-do,2012,30-39 Years old,135344,79989,55355
1731,Gyeongsangnam-do,2012,40-49 Years old,213184,123935,89249
1732,Gyeongsangnam-do,2012,50-59 Years old,213838,128576,85262
1733,Gyeongsangnam-do,2012,60-69 Years old,128329,78677,49652
1734,Gyeongsangnam-do,2012,70-79 Years old,83749,49205,34544
1735,Gyeongsangnam-do,2012,80 years and over,21883,12949,8934
1736,Gyeongsangnam-do,2012,dead,32837,28523,4314
1737,Gyeongsangnam-do,2013,Total,881925,528974,352951
1738,Gyeongsangnam-do,2013,Under 30 years,16998,10053,6945
1739,Gyeongsangnam-do,2013,30-39 Years old,133317,79469,53848
1740,Gyeongsangnam-do,2013,40-49 Years old,219704,125809,93895
1741,Gyeongsangnam-do,2013,50-59 Years old,225647,133656,91991
1742,Gyeongsangnam-do,2013,60-69 Years old,135875,82546,53329
1743,Gyeongsangnam-do,2013,70-79 Years old,90444,52508,37936
1744,Gyeongsangnam-do,2013,80 years and over,25102,14661,10441
1745,Gyeongsangnam-do,2013,dead,34838,30272,4566
1746,Gyeongsangnam-do,2014,Total,904834,537453,367381
1747,Gyeongsangnam-do,2014,Under 30 years,16488,9903,6585
1748,Gyeongsangnam-do,2014,30-39 Years old,135844,81772,54072
1749,Gyeongsangnam-do,2014,40-49 Years old,227190,128600,98590
1750,Gyeongsangnam-do,2014,50-59 Years old,229639,133264,96375
1751,Gyeongsangnam-do,2014,60-69 Years old,141508,85119,56389
1752,Gyeongsangnam-do,2014,70-79 Years old,91456,52365,39091
1753,Gyeongsangnam-do,2014,80 years and over,24778,13468,11310
1754,Gyeongsangnam-do,2014,dead,37931,32962,4969
1755,Gyeongsangnam-do,2015,Total,928149,544657,383492
1756,Gyeongsangnam-do,2015,Under 30 years,19304,11310,7994
1757,Gyeongsangnam-do,2015,30-39 Years old,137885,84179,53706
1758,Gyeongsangnam-do,2015,40-49 Years old,231111,129557,101554
1759,Gyeongsangnam-do,2015,50-59 Years old,234926,133733,101193
1760,Gyeongsangnam-do,2015,60-69 Years old,151735,89526,62209
1761,Gyeongsangnam-do,2015,70-79 Years old,90284,50934,39350
1762,Gyeongsangnam-do,2015,80 years and over,26509,14005,12504
1763,Gyeongsangnam-do,2015,dead,36395,31413,4982
1764,Gyeongsangnam-do,2016,Total,949755,554258,395497
1765,Gyeongsangnam-do,2016,Under 30 years,16858,9984,6874
1766,Gyeongsangnam-do,2016,30-39 Years old,134884,83192,51692
1767,Gyeongsangnam-do,2016,40-49 Years old,230962,128720,102242
1768,Gyeongsangnam-do,2016,50-59 Years old,241050,135344,105706
1769,Gyeongsangnam-do,2016,60-69 Years old,164403,95735,68668
1770,Gyeongsangnam-do,2016,70-79 Years old,92703,51990,40713
1771,Gyeongsangnam-do,2016,80 years and over,30042,15849,14193
1772,Gyeongsangnam-do,2016,dead,38853,33444,5409
1773,Gyeongsangnam-do,2017,Total,986620,573282,413338
1774,Gyeongsangnam-do,2017,Under 30 years,16077,9628,6449
1775,Gyeongsangnam-do,2017,30-39 Years old,133527,83036,50491
1776,Gyeongsangnam-do,2017,40-49 Years old,234114,130813,103301
1777,Gyeongsangnam-do,2017,50-59 Years old,249001,137953,111048
1778,Gyeongsangnam-do,2017,60-69 Years old,178191,102863,75328
1779,Gyeongsangnam-do,2017,70-79 Years old,100405,56224,44181
1780,Gyeongsangnam-do,2017,80 years and over,35180,18401,16779
1781,Gyeongsangnam-do,2017,dead,40125,34364,5761
1782,Gyeongsangnam-do,2018,Total,1009747,582339,427408
1783,Gyeongsangnam-do,2018,Under 30 years,15701,9277,6424
1784,Gyeongsangnam-do,2018,30-39 Years old,129950,80977,48973
1785,Gyeongsangnam-do,2018,40-49 Years old,233427,131029,102398
1786,Gyeongsangnam-do,2018,50-59 Years old,257087,140134,116953
1787,Gyeongsangnam-do,2018,60-69 Years old,188383,107458,80925
1788,Gyeongsangnam-do,2018,70-79 Years old,106093,59105,46988
1789,Gyeongsangnam-do,2018,80 years and over,40395,21593,18802
1790,Gyeongsangnam-do,2018,dead,38711,32766,5945
1791,Gyeongsangnam-do,2019,Total,1033218,592508,440710
1792,Gyeongsangnam-do,2019,Under 30 years,15250,9032,6218
1793,Gyeongsangnam-do,2019,30-39 Years old,123744,77194,46550
1794,Gyeongsangnam-do,2019,40-49 Years old,234304,132187,102117
1795,Gyeongsangnam-do,2019,50-59 Years old,264220,142670,121550
1796,Gyeongsangnam-do,2019,60-69 Years old,200513,112895,87618
1797,Gyeongsangnam-do,2019,70-79 Years old,111076,61627,49449
1798,Gyeongsangnam-do,2019,80 years and over,44503,23512,20991
1799,Gyeongsangnam-do,2019,dead,39608,33391,6217
1800,Gyeongsangnam-do,2020,Total,1055150,600581,454569
1801,Gyeongsangnam-do,2020,Under 30 years,15266,8939,6327
1802,Gyeongsangnam-do,2020,30-39 Years old,115864,72212,43652
1803,Gyeongsangnam-do,2020,40-49 Years old,235054,133357,101697
1804,Gyeongsangnam-do,2020,50-59 Years old,267339,142902,124437
1805,Gyeongsangnam-do,2020,60-69 Years old,217185,120542,96643
1806,Gyeongsangnam-do,2020,70-79 Years old,115836,63959,51877
1807,Gyeongsangnam-do,2020,80 years and over,48800,25310,23490
1808,Gyeongsangnam-do,2020,dead,39806,33360,6446
1809,Gyeongsangnam-do,2021,Total,1075438,607168,468270
1810,Gyeongsangnam-do,2021,Under 30 years,16153,9393,6760
1811,Gyeongsangnam-do,2021,30-39 Years old,110497,68645,41852
1812,Gyeongsangnam-do,2021,40-49 Years old,233272,133148,100124
1813,Gyeongsangnam-do,2021,50-59 Years old,269274,142705,126569
1814,Gyeongsangnam-do,2021,60-69 Years old,234455,128050,106405
1815,Gyeongsangnam-do,2021,70-79 Years old,119653,65441,54212
1816,Gyeongsangnam-do,2021,80 years and over,52855,27031,25824
1817,Gyeongsangnam-do,2021,dead,39279,32755,6524
1818,Gyeongsangnam-do,2022,Total,1080564,605677,474887
1819,Gyeongsangnam-do,2022,Under 30 years,14926,8586,6340
1820,Gyeongsangnam-do,2022,30-39 Years old,100303,62307,37996
1821,Gyeongsangnam-do,2022,40-49 Years old,230292,132194,98098
1822,Gyeongsangnam-do,2022,50-59 Years old,270660,142918,127742
1823,Gyeongsangnam-do,2022,60-69 Years old,244797,132204,112593
1824,Gyeongsangnam-do,2022,70-79 Years old,125164,68053,57111
1825,Gyeongsangnam-do,2022,80 years and over,57190,28763,28427
1826,Gyeongsangnam-do,2022,dead,37232,30652,6580
1827,Gyeongsangnam-do,2023,Total,1089324,606427,482897
1828,Gyeongsangnam-do,2023,Under 30 years,13250,7533,5717
1829,Gyeongsangnam-do,2023,30-39 Years old,90665,56124,34541
1830,Gyeongsangnam-do,2023,40-49 Years old,224184,129904,94280
1831,Gyeongsangnam-do,2023,50-59 Years old,275180,144589,130591
1832,Gyeongsangnam-do,2023,60-69 Years old,256638,137456,119182
1833,Gyeongsangnam-do,2023,70-79 Years old,131630,70888,60742
1834,Gyeongsangnam-do,2023,80 years and over,61224,30101,31123
1835,Gyeongsangnam-do,2023,dead,36553,29832,6721
1836,Jeju,2012,Total,131814,78567,53247
1837,Jeju,2012,Under 30 years,2542,1524,1018
1838,Jeju,2012,30-39 Years old,18011,10439,7572
1839,Jeju,2012,40-49 Years old,34121,19448,14673
1840,Jeju,2012,50-59 Years old,32092,19023,13069
1841,Jeju,2012,60-69 Years old,22352,13982,8370
1842,Jeju,2012,70-79 Years old,14457,8777,5680
1843,Jeju,2012,80 years and over,3337,1533,1804
1844,Jeju,2012,dead,4902,3841,1061
1845,Jeju,2013,Total,136441,80194,56247
1846,Jeju,2013,Under 30 years,2431,1426,1005
1847,Jeju,2013,30-39 Years old,18330,10557,7773
1848,Jeju,2013,40-49 Years old,35237,19670,15567
1849,Jeju,2013,50-59 Years old,34050,19842,14208
1850,Jeju,2013,60-69 Years old,22671,13917,8754
1851,Jeju,2013,70-79 Years old,14750,8930,5820
1852,Jeju,2013,80 years and over,3838,1814,2024
1853,Jeju,2013,dead,5134,4038,1096
1854,Jeju,2014,Total,143658,83707,59951
1855,Jeju,2014,Under 30 years,2547,1510,1037
1856,Jeju,2014,30-39 Years old,19035,10942,8093
1857,Jeju,2014,40-49 Years old,37211,20546,16665
1858,Jeju,2014,50-59 Years old,35971,20648,15323
1859,Jeju,2014,60-69 Years old,23536,14184,9352
1860,Jeju,2014,70-79 Years old,15621,9496,6125
1861,Jeju,2014,80 years and over,4250,2076,2174
1862,Jeju,2014,dead,5487,4305,1182
1863,Jeju,2015,Total,152997,88130,64867
1864,Jeju,2015,Under 30 years,3172,1877,1295
1865,Jeju,2015,30-39 Years old,19968,11515,8453
1866,Jeju,2015,40-49 Years old,39233,21533,17700
1867,Jeju,2015,50-59 Years old,37963,21351,16612
1868,Jeju,2015,60-69 Years old,25816,15224,10592
1869,Jeju,2015,70-79 Years old,16592,10006,6586
1870,Jeju,2015,80 years and over,4856,2396,2460
1871,Jeju,2015,dead,5397,4228,1169
1872,Jeju,2016,Total,160551,91407,69144
1873,Jeju,2016,Under 30 years,2988,1804,1184
1874,Jeju,2016,30-39 Years old,20823,11924,8899
1875,Jeju,2016,40-49 Years old,40713,22129,18584
1876,Jeju,2016,50-59 Years old,40381,22283,18098
1877,Jeju,2016,60-69 Years old,27690,16027,11663
1878,Jeju,2016,70-79 Years old,17249,10319,6930
1879,Jeju,2016,80 years and over,5350,2733,2617
1880,Jeju,2016,dead,5357,4188,1169
1881,Jeju,2017,Total,168750,95405,73345
1882,Jeju,2017,Under 30 years,3171,1911,1260
1883,Jeju,2017,30-39 Years old,21322,12256,9066
1884,Jeju,2017,40-49 Years old,42786,23096,19690
1885,Jeju,2017,50-59 Years old,42569,23165,19404
1886,Jeju,2017,60-69 Years old,29384,16874,12510
1887,Jeju,2017,70-79 Years old,18239,10902,7337
1888,Jeju,2017,80 years and over,5882,3015,2867
1889,Jeju,2017,dead,5397,4186,1211
1890,Jeju,2018,Total,175539,98204,77335
1891,Jeju,2018,Under 30 years,3479,2077,1402
1892,Jeju,2018,30-39 Years old,21792,12480,9312
1893,Jeju,2018,40-49 Years old,43737,23549,20188
1894,Jeju,2018,50-59 Years old,45063,24113,20950
1895,Jeju,2018,60-69 Years old,30814,17414,13400
1896,Jeju,2018,70-79 Years old,18986,11237,7749
1897,Jeju,2018,80 years and over,6569,3454,3115
1898,Jeju,2018,dead,5099,3880,1219
1899,Jeju,2019,Total,180441,100532,79909
1900,Jeju,2019,Under 30 years,3376,2026,1350
1901,Jeju,2019,30-39 Years old,20833,11966,8867
1902,Jeju,2019,40-49 Years old,44047,23769,20278
1903,Jeju,2019,50-59 Years old,46952,24929,22023
1904,Jeju,2019,60-69 Years old,33074,18445,14629
1905,Jeju,2019,70-79 Years old,19755,11625,8130
1906,Jeju,2019,80 years and over,7271,3875,3396
1907,Jeju,2019,dead,5133,3897,1236
1908,Jeju,2020,Total,185048,102309,82739
1909,Jeju,2020,Under 30 years,3512,2069,1443
1910,Jeju,2020,30-39 Years old,19949,11363,8586
1911,Jeju,2020,40-49 Years old,43908,23778,20130
1912,Jeju,2020,50-59 Years old,48557,25518,23039
1913,Jeju,2020,60-69 Years old,35713,19629,16084
1914,Jeju,2020,70-79 Years old,20309,11837,8472
1915,Jeju,2020,80 years and over,7958,4209,3749
1916,Jeju,2020,dead,5142,3906,1236
1917,Jeju,2021,Total,191211,104879,86332
1918,Jeju,2021,Under 30 years,3836,2222,1614
1919,Jeju,2021,30-39 Years old,19895,11297,8598
1920,Jeju,2021,40-49 Years old,44235,23945,20290
1921,Jeju,2021,50-59 Years old,50494,26341,24153
1922,Jeju,2021,60-69 Years old,38402,20741,17661
1923,Jeju,2021,70-79 Years old,20650,11928,8722
1924,Jeju,2021,80 years and over,8624,4554,4070
1925,Jeju,2021,dead,5075,3851,1224
1926,Jeju,2022,Total,196528,107195,89333
1927,Jeju,2022,Under 30 years,3758,2160,1598
1928,Jeju,2022,30-39 Years old,19228,10918,8310
1929,Jeju,2022,40-49 Years old,44848,24377,20471
1930,Jeju,2022,50-59 Years old,52295,27203,25092
1931,Jeju,2022,60-69 Years old,40636,21579,19057
1932,Jeju,2022,70-79 Years old,21281,12164,9117
1933,Jeju,2022,80 years and over,9405,4974,4431
1934,Jeju,2022,dead,5077,3820,1257
1935,Jeju,2023,Total,200438,108874,91564
1936,Jeju,2023,Under 30 years,3454,1992,1462
1937,Jeju,2023,30-39 Years old,18498,10487,8011
1938,Jeju,2023,40-49 Years old,44302,24232,20070
1939,Jeju,2023,50-59 Years old,53476,27656,25820
1940,Jeju,2023,60-69 Years old,43487,22995,20492
1941,Jeju,2023,70-79 Years old,22078,12428,9650
1942,Jeju,2023,80 years and over,10067,5266,4801
1943,Jeju,2023,dead,5076,3818,1258
