"Province","Year","Age",Total,Male,Female
"Whole country","2012","Total",12032798,7047944,4984854
"Whole country","2012","Under 30 years",282910,156530,126380
"Whole country","2012","30-39 Years old",1941927,1123901,818026
"Whole country","2012","40-49 Years old",3108057,1771633,1336424
"Whole country","2012","50-59 Years old",3090353,1799567,1290786
"Whole country","2012","60-69 Years old",1913052,1139882,773170
"Whole country","2012","70-79 Years old",1156929,676314,480615
"Whole country","2012","80 years and over",264280,147203,117077
"Whole country","2012","dead",275290,232914,42376
"Whole country","2013","Total",12398627,7205138,5193489
"Whole country","2013","Under 30 years",252730,140344,112386
"Whole country","2013","30-39 Years old",1876828,1088176,788652
"Whole country","2013","40-49 Years old",3166585,1783058,1383527
"Whole country","2013","50-59 Years old",3235769,1859636,1376133
"Whole country","2013","60-69 Years old",2006125,1183435,822690
"Whole country","2013","70-79 Years old",1259948,732289,527659
"Whole country","2013","80 years and over",308122,170351,137771
"Whole country","2013","dead",292520,247849,44671
"Whole country","2014","Total",12650446,7281977,5368469
"Whole country","2014","Under 30 years",240293,134155,106138
"Whole country","2014","30-39 Years old",1841226,1073637,767589
"Whole country","2014","40-49 Years old",3231720,1801109,1430611
"Whole country","2014","50-59 Years old",3302097,1864412,1437685
"Whole country","2014","60-69 Years old",2089927,1218026,871901
"Whole country","2014","70-79 Years old",1303758,749007,554751
"Whole country","2014","80 years and over",325782,173816,151966
"Whole country","2014","dead",315643,267815,47828
"Whole country","2015","Total",13044592,7420711,5623881
"Whole country","2015","Under 30 years",275103,152291,122812
"Whole country","2015","30-39 Years old",1855775,1088849,766926
"Whole country","2015","40-49 Years old",3280918,1811469,1469449
"Whole country","2015","50-59 Years old",3376615,1869816,1506799
"Whole country","2015","60-69 Years old",2243668,1285274,958394
"Whole country","2015","70-79 Years old",1337172,759308,577864
"Whole country","2015","80 years and over",366776,193279,173497
"Whole country","2015","dead",308565,260425,48140
"Whole country","2016","Total",13311319,7509980,5801339
"Whole country","2016","Under 30 years",252840,140309,112531
"Whole country","2016","30-39 Years old",1831033,1080179,750854
"Whole country","2016","40-49 Years old",3291308,1805209,1486099
"Whole country","2016","50-59 Years old",3439685,1876111,1563574
"Whole country","2016","60-69 Years old",2383245,1344462,1038783
"Whole country","2016","70-79 Years old",1375881,773971,601910
"Whole country","2016","80 years and over",415544,218645,196899
"Whole country","2016","dead",321783,271094,50689
"Whole country","2017","Total",13669851,7666849,6003002
"Whole country","2017","Under 30 years",252676,140360,112316
"Whole country","2017","30-39 Years old",1805119,1069615,735504
"Whole country","2017","40-49 Years old",3316590,1819578,1497012
"Whole country","2017","50-59 Years old",3502715,1884236,1618479
"Whole country","2017","60-69 Years old",2516893,1405068,1111825
"Whole country","2017","70-79 Years old",1473092,822892,650200
"Whole country","2017","80 years and over",473021,248717,224304
"Whole country","2017","dead",329745,276383,53362
"Whole country","2018","Total",14010290,7796112,6214178
"Whole country","2018","Under 30 years",257292,142123,115169
"Whole country","2018","30-39 Years old",1801650,1068892,732758
"Whole country","2018","40-49 Years old",3309561,1819350,1490211
"Whole country","2018","50-59 Years old",3600518,1908829,1691689
"Whole country","2018","60-69 Years old",2640555,1453325,1187230
"Whole country","2018","70-79 Years old",1541530,852061,689469
"Whole country","2018","80 years and over",535334,283637,251697
"Whole country","2018","dead",323850,267895,55955
"Whole country","2019","Total",14335723,7922076,6413647
"Whole country","2019","Under 30 years",250362,137260,113102
"Whole country","2019","30-39 Years old",1741549,1033528,708021
"Whole country","2019","40-49 Years old",3316628,1831187,1485441
"Whole country","2019","50-59 Years old",3689400,1936430,1752970
"Whole country","2019","60-69 Years old",2799643,1518678,1280965
"Whole country","2019","70-79 Years old",1612620,881862,730758
"Whole country","2019","80 years and over",598223,313984,284239
"Whole country","2019","dead",327298,269147,58151
"Whole country","2020","Total",14696617,8055345,6641272
"Whole country","2020","Under 30 years",265312,144581,120731
"Whole country","2020","30-39 Years old",1680384,993113,687271
"Whole country","2020","40-49 Years old",3337805,1848890,1488915
"Whole country","2020","50-59 Years old",3735459,1944969,1790490
"Whole country","2020","60-69 Years old",3011572,1606968,1404604
"Whole country","2020","70-79 Years old",1680030,908455,771575
"Whole country","2020","80 years and over",658604,340544,318060
"Whole country","2020","dead",327451,267825,59626
"Whole country","2021","Total",15089160,8205832,6883328
"Whole country","2021","Under 30 years",291496,158053,133443
"Whole country","2021","30-39 Years old",1646737,966521,680216
"Whole country","2021","40-49 Years old",3335444,1857714,1477730
"Whole country","2021","50-59 Years old",3793303,1964907,1828396
"Whole country","2021","60-69 Years old",3256053,1710826,1545227
"Whole country","2021","70-79 Years old",1722827,919664,803163
"Whole country","2021","80 years and over",723771,369045,354726
"Whole country","2021","dead",319529,259102,60427
"Whole country","2022","Total",15309392,8280854,7028538
"Whole country","2022","Under 30 years",274062,147709,126353
"Whole country","2022","30-39 Years old",1541372,900822,640550
"Whole country","2022","40-49 Years old",3324304,1862073,1462231
"Whole country","2022","50-59 Years old",3851520,1992505,1859015
"Whole country","2022","60-69 Years old",3386411,1761125,1625286
"Whole country","2022","70-79 Years old",1794585,947437,847148
"Whole country","2022","80 years and over",808358,406519,401839
"Whole country","2022","dead",328780,262664,66116
"Whole country","2023","Total",15618261,8408927,7209334
"Whole country","2023","Under 30 years",251544,135381,116163
"Whole country","2023","30-39 Years old",1479689,862849,616840
"Whole country","2023","40-49 Years old",3305362,1866321,1439041
"Whole country","2023","50-59 Years old",3938164,2034884,1903280
"Whole country","2023","60-69 Years old",3553549,1833085,1720464
"Whole country","2023","70-79 Years old",1880330,981261,899069
"Whole country","2023","80 years and over",879875,434080,445795
"Whole country","2023","dead",329748,261066,68682
"Seoul","2012","Total",2286639,1279363,1007276
"Seoul","2012","Under 30 years",56359,29962,26397
"Seoul","2012","30-39 Years old",373082,208947,164135
"Seoul","2012","40-49 Years old",572673,315961,256712
"Seoul","2012","50-59 Years old",600690,330606,270084
"Seoul","2012","60-69 Years old",403231,233455,169776
"Seoul","2012","70-79 Years old",215806,123630,92176
"Seoul","2012","80 years and over",45835,22829,23006
"Seoul","2012","dead",18963,13973,4990
"Seoul","2013","Total",2306750,1280274,1026476
"Seoul","2013","Under 30 years",48686,25746,22940
"Seoul","2013","30-39 Years old",349106,194964,154142
"Seoul","2013","40-49 Years old",577806,315927,261879
"Seoul","2013","50-59 Years old",610404,331905,278499
"Seoul","2013","60-69 Years old",414937,237187,177750
"Seoul","2013","70-79 Years old",234031,134136,99895
"Seoul","2013","80 years and over",52273,26041,26232
"Seoul","2013","dead",19507,14368,5139
"Seoul","2014","Total",2343420,1288868,1054552
"Seoul","2014","Under 30 years",44964,23712,21252
"Seoul","2014","30-39 Years old",334215,186613,147602
"Seoul","2014","40-49 Years old",586890,318378,268512
"Seoul","2014","50-59 Years old",617810,330607,287203
"Seoul","2014","60-69 Years old",432347,243880,188467
"Seoul","2014","70-79 Years old",249074,141849,107225
"Seoul","2014","80 years and over",57687,28773,28914
"Seoul","2014","dead",20433,15056,5377
"Seoul","2015","Total",2386284,1297000,1089284
"Seoul","2015","Under 30 years",48876,25421,23455
"Seoul","2015","30-39 Years old",329574,184080,145494
"Seoul","2015","40-49 Years old",588654,315886,272768
"Seoul","2015","50-59 Years old",615893,323461,292432
"Seoul","2015","60-69 Years old",456428,252657,203771
"Seoul","2015","70-79 Years old",260688,147577,113111
"Seoul","2015","80 years and over",65969,33125,32844
"Seoul","2015","dead",20202,14793,5409
"Seoul","2016","Total",2412355,1296509,1115846
"Seoul","2016","Under 30 years",46637,24211,22426
"Seoul","2016","30-39 Years old",324762,181221,143541
"Seoul","2016","40-49 Years old",589865,313431,276434
"Seoul","2016","50-59 Years old",614204,317841,296363
"Seoul","2016","60-69 Years old",473306,257146,216160
"Seoul","2016","70-79 Years old",269801,150743,119058
"Seoul","2016","80 years and over",73479,37051,36428
"Seoul","2016","dead",20301,14865,5436
"Seoul","2017","Total",2436182,1295024,1141158
"Seoul","2017","Under 30 years",47814,24615,23199
"Seoul","2017","30-39 Years old",321360,178526,142834
"Seoul","2017","40-49 Years old",587296,310785,276511
"Seoul","2017","50-59 Years old",609218,310258,298960
"Seoul","2017","60-69 Years old",483441,258073,225368
"Seoul","2017","70-79 Years old",284739,156554,128185
"Seoul","2017","80 years and over",81899,41410,40489
"Seoul","2017","dead",20415,14803,5612
"Seoul","2018","Total",2459986,1295775,1164211
"Seoul","2018","Under 30 years",48966,25008,23958
"Seoul","2018","30-39 Years old",317621,175648,141973
"Seoul","2018","40-49 Years old",577124,304726,272398
"Seoul","2018","50-59 Years old",611847,308204,303643
"Seoul","2018","60-69 Years old",495253,259772,235481
"Seoul","2018","70-79 Years old",297209,161201,136008
"Seoul","2018","80 years and over",91093,46163,44930
"Seoul","2018","dead",20873,15053,5820
"Seoul","2019","Total",2483492,1297708,1185784
"Seoul","2019","Under 30 years",47364,24017,23347
"Seoul","2019","30-39 Years old",300102,164563,135539
"Seoul","2019","40-49 Years old",569096,300689,268407
"Seoul","2019","50-59 Years old",617201,309076,308125
"Seoul","2019","60-69 Years old",514797,265841,248956
"Seoul","2019","70-79 Years old",311186,166491,144695
"Seoul","2019","80 years and over",102982,52244,50738
"Seoul","2019","dead",20764,14787,5977
"Seoul","2020","Total",2536442,1314345,1222097
"Seoul","2020","Under 30 years",52860,26566,26294
"Seoul","2020","30-39 Years old",298270,161985,136285
"Seoul","2020","40-49 Years old",566321,298888,267433
"Seoul","2020","50-59 Years old",621708,310376,311332
"Seoul","2020","60-69 Years old",540208,274197,266011
"Seoul","2020","70-79 Years old",322830,170555,152275
"Seoul","2020","80 years and over",114439,57715,56724
"Seoul","2020","dead",19806,14063,5743
"Seoul","2021","Total",2602070,1340027,1262043
"Seoul","2021","Under 30 years",59226,29402,29824
"Seoul","2021","30-39 Years old",300627,161133,139494
"Seoul","2021","40-49 Years old",564074,298662,265412
"Seoul","2021","50-59 Years old",631377,315632,315745
"Seoul","2021","60-69 Years old",570582,285677,284905
"Seoul","2021","70-79 Years old",328358,171093,157265
"Seoul","2021","80 years and over",127834,64419,63415
"Seoul","2021","dead",19992,14009,5983
"Seoul","2022","Total",2628669,1346726,1281943
"Seoul","2022","Under 30 years",56660,28019,28641
"Seoul","2022","30-39 Years old",281475,149501,131974
"Seoul","2022","40-49 Years old",559966,297019,262947
"Seoul","2022","50-59 Years old",641604,321544,320060
"Seoul","2022","60-69 Years old",580581,287592,292989
"Seoul","2022","70-79 Years old",340628,174971,165657
"Seoul","2022","80 years and over",146204,73157,73047
"Seoul","2022","dead",21551,14923,6628
"Seoul","2023","Total",2643465,1348979,1294486
"Seoul","2023","Under 30 years",51824,25655,26169
"Seoul","2023","30-39 Years old",262277,138474,123803
"Seoul","2023","40-49 Years old",550483,293063,257420
"Seoul","2023","50-59 Years old",650148,326481,323667
"Seoul","2023","60-69 Years old",593517,291916,301601
"Seoul","2023","70-79 Years old",353318,179346,173972
"Seoul","2023","80 years and over",160972,79709,81263
"Seoul","2023","dead",20926,14335,6591
"Busan","2012","Total",874492,487550,386942
"Busan","2012","Under 30 years",19094,10215,8879
"Busan","2012","30-39 Years old",126565,70752,55813
"Busan","2012","40-49 Years old",203909,107822,96087
"Busan","2012","50-59 Years old",249395,136761,112634
"Busan","2012","60-69 Years old",163349,95909,67440
"Busan","2012","70-79 Years old",82635,47211,35424
"Busan","2012","80 years and over",15379,7841,7538
"Busan","2012","dead",14166,11039,3127
"Busan","2013","Total",909885,502201,407684
"Busan","2013","Under 30 years",17269,9284,7985
"Busan","2013","30-39 Years old",123796,69445,54351
"Busan","2013","40-49 Years old",206055,108133,97922
"Busan","2013","50-59 Years old",259126,139457,119669
"Busan","2013","60-69 Years old",174590,100751,73839
"Busan","2013","70-79 Years old",95219,53960,41259
"Busan","2013","80 years and over",18793,9474,9319
"Busan","2013","dead",15037,11697,3340
"Busan","2014","Total",923056,504054,419002
"Busan","2014","Under 30 years",16180,8839,7341
"Busan","2014","30-39 Years old",121996,68918,53078
"Busan","2014","40-49 Years old",208578,108603,99975
"Busan","2014","50-59 Years old",257764,135487,122277
"Busan","2014","60-69 Years old",181462,102749,78713
"Busan","2014","70-79 Years old",100365,56597,43768
"Busan","2014","80 years and over",20616,10340,10276
"Busan","2014","dead",16095,12521,3574
"Busan","2015","Total",950203,511698,438505
"Busan","2015","Under 30 years",17804,9550,8254
"Busan","2015","30-39 Years old",122574,69657,52917
"Busan","2015","40-49 Years old",211192,109358,101834
"Busan","2015","50-59 Years old",256893,131664,125229
"Busan","2015","60-69 Years old",196100,108358,87742
"Busan","2015","70-79 Years old",105793,59005,46788
"Busan","2015","80 years and over",24128,12009,12119
"Busan","2015","dead",15719,12097,3622
"Busan","2016","Total",959418,510334,449084
"Busan","2016","Under 30 years",16970,9119,7851
"Busan","2016","30-39 Years old",121982,69615,52367
"Busan","2016","40-49 Years old",210121,108339,101782
"Busan","2016","50-59 Years old",254641,127638,127003
"Busan","2016","60-69 Years old",205148,110601,94547
"Busan","2016","70-79 Years old",107689,59515,48174
"Busan","2016","80 years and over",27157,13486,13671
"Busan","2016","dead",15710,12021,3689
"Busan","2017","Total",973593,513794,459799
"Busan","2017","Under 30 years",16588,8943,7645
"Busan","2017","30-39 Years old",118460,67807,50653
"Busan","2017","40-49 Years old",208817,108278,100539
"Busan","2017","50-59 Years old",252548,124583,127965
"Busan","2017","60-69 Years old",214267,113463,100804
"Busan","2017","70-79 Years old",115600,62949,52651
"Busan","2017","80 years and over",30924,15343,15581
"Busan","2017","dead",16389,12428,3961
"Busan","2018","Total",980424,513980,466444
"Busan","2018","Under 30 years",15375,8256,7119
"Busan","2018","30-39 Years old",112119,64299,47820
"Busan","2018","40-49 Years old",205127,107292,97835
"Busan","2018","50-59 Years old",251782,122656,129126
"Busan","2018","60-69 Years old",220893,115030,105863
"Busan","2018","70-79 Years old",122835,66139,56696
"Busan","2018","80 years and over",34926,17292,17634
"Busan","2018","dead",17367,13016,4351
"Busan","2019","Total",986976,513969,473007
"Busan","2019","Under 30 years",14107,7540,6567
"Busan","2019","30-39 Years old",103194,59229,43965
"Busan","2019","40-49 Years old",202929,107312,95617
"Busan","2019","50-59 Years old",249838,120493,129345
"Busan","2019","60-69 Years old",229175,117257,111918
"Busan","2019","70-79 Years old",129547,68812,60735
"Busan","2019","80 years and over",39629,19555,20074
"Busan","2019","dead",18557,13771,4786
"Busan","2020","Total",1001906,517709,484197
"Busan","2020","Under 30 years",14337,7584,6753
"Busan","2020","30-39 Years old",97286,55816,41470
"Busan","2020","40-49 Years old",204662,109114,95548
"Busan","2020","50-59 Years old",246238,118233,128005
"Busan","2020","60-69 Years old",240931,120480,120451
"Busan","2020","70-79 Years old",135123,70788,64335
"Busan","2020","80 years and over",44323,21698,22625
"Busan","2020","dead",19006,13996,5010
"Busan","2021","Total",1019096,521484,497612
"Busan","2021","Under 30 years",16372,8591,7781
"Busan","2021","30-39 Years old",94141,53624,40517
"Busan","2021","40-49 Years old",204191,109591,94600
"Busan","2021","50-59 Years old",243735,116743,126992
"Busan","2021","60-69 Years old",253198,123668,129530
"Busan","2021","70-79 Years old",139640,71886,67754
"Busan","2021","80 years and over",49490,23914,25576
"Busan","2021","dead",18329,13467,4862
"Busan","2022","Total",1030185,524025,506160
"Busan","2022","Under 30 years",15960,8355,7605
"Busan","2022","30-39 Years old",88663,50476,38187
"Busan","2022","40-49 Years old",201989,109144,92845
"Busan","2022","50-59 Years old",242329,116514,125815
"Busan","2022","60-69 Years old",258354,124068,134286
"Busan","2022","70-79 Years old",146791,74223,72568
"Busan","2022","80 years and over",56513,27036,29477
"Busan","2022","dead",19586,14209,5377
"Busan","2023","Total",1051261,531965,519296
"Busan","2023","Under 30 years",14460,7551,6909
"Busan","2023","30-39 Years old",84989,48460,36529
"Busan","2023","40-49 Years old",202455,110302,92153
"Busan","2023","50-59 Years old",245421,118460,126961
"Busan","2023","60-69 Years old",266290,126459,139831
"Busan","2023","70-79 Years old",154637,76696,77941
"Busan","2023","80 years and over",63039,29769,33270
"Busan","2023","dead",19970,14268,5702
"Daegu","2012","Total",594293,342198,252095
"Daegu","2012","Under 30 years",11641,6685,4956
"Daegu","2012","30-39 Years old",90101,51947,38154
"Daegu","2012","40-49 Years old",159545,88828,70717
"Daegu","2012","50-59 Years old",159789,91654,68135
"Daegu","2012","60-69 Years old",98363,58231,40132
"Daegu","2012","70-79 Years old",55576,32140,23436
"Daegu","2012","80 years and over",11170,6156,5014
"Daegu","2012","dead",8108,6557,1551
"Daegu","2013","Total",611890,348109,263781
"Daegu","2013","Under 30 years",10947,6333,4614
"Daegu","2013","30-39 Years old",89773,51842,37931
"Daegu","2013","40-49 Years old",161476,88556,72920
"Daegu","2013","50-59 Years old",164894,92935,71959
"Daegu","2013","60-69 Years old",102672,59659,43013
"Daegu","2013","70-79 Years old",60641,34864,25777
"Daegu","2013","80 years and over",13013,7072,5941
"Daegu","2013","dead",8474,6848,1626
"Daegu","2014","Total",623401,350796,272605
"Daegu","2014","Under 30 years",10214,5983,4231
"Daegu","2014","30-39 Years old",87882,51107,36775
"Daegu","2014","40-49 Years old",163950,89026,74924
"Daegu","2014","50-59 Years old",169137,93462,75675
"Daegu","2014","60-69 Years old",106520,60981,45539
"Daegu","2014","70-79 Years old",62886,35666,27220
"Daegu","2014","80 years and over",13919,7374,6545
"Daegu","2014","dead",8893,7197,1696
"Daegu","2015","Total",639235,356387,282848
"Daegu","2015","Under 30 years",10979,6389,4590
"Daegu","2015","30-39 Years old",85017,49670,35347
"Daegu","2015","40-49 Years old",163718,88440,75278
"Daegu","2015","50-59 Years old",172457,93603,78854
"Daegu","2015","60-69 Years old",115349,65041,50308
"Daegu","2015","70-79 Years old",65519,36790,28729
"Daegu","2015","80 years and over",16574,8704,7870
"Daegu","2015","dead",9622,7750,1872
"Daegu","2016","Total",653026,360678,292348
"Daegu","2016","Under 30 years",10384,6098,4286
"Daegu","2016","30-39 Years old",84104,49602,34502
"Daegu","2016","40-49 Years old",164066,88296,75770
"Daegu","2016","50-59 Years old",175563,93682,81881
"Daegu","2016","60-69 Years old",123203,68178,55025
"Daegu","2016","70-79 Years old",66796,37023,29773
"Daegu","2016","80 years and over",19040,9935,9105
"Daegu","2016","dead",9870,7864,2006
"Daegu","2017","Total",671684,367859,303825
"Daegu","2017","Under 30 years",10968,6482,4486
"Daegu","2017","30-39 Years old",84329,50277,34052
"Daegu","2017","40-49 Years old",165173,88844,76329
"Daegu","2017","50-59 Years old",179524,94078,85446
"Daegu","2017","60-69 Years old",129745,70689,59056
"Daegu","2017","70-79 Years old",70855,38752,32103
"Daegu","2017","80 years and over",21476,11096,10380
"Daegu","2017","dead",9614,7641,1973
"Daegu","2018","Total",683423,371500,311923
"Daegu","2018","Under 30 years",11174,6478,4696
"Daegu","2018","30-39 Years old",83708,50289,33419
"Daegu","2018","40-49 Years old",162038,87371,74667
"Daegu","2018","50-59 Years old",184010,95029,88981
"Daegu","2018","60-69 Years old",133976,71916,62060
"Daegu","2018","70-79 Years old",74500,40135,34365
"Daegu","2018","80 years and over",24030,12437,11593
"Daegu","2018","dead",9987,7845,2142
"Daegu","2019","Total",690770,371768,319002
"Daegu","2019","Under 30 years",10932,6286,4646
"Daegu","2019","30-39 Years old",79337,48012,31325
"Daegu","2019","40-49 Years old",159955,86421,73534
"Daegu","2019","50-59 Years old",185774,94628,91146
"Daegu","2019","60-69 Years old",139873,73625,66248
"Daegu","2019","70-79 Years old",78287,41514,36773
"Daegu","2019","80 years and over",27019,13809,13210
"Daegu","2019","dead",9593,7473,2120
"Daegu","2020","Total",698114,372185,325929
"Daegu","2020","Under 30 years",10879,6185,4694
"Daegu","2020","30-39 Years old",73946,44947,28999
"Daegu","2020","40-49 Years old",157668,85564,72104
"Daegu","2020","50-59 Years old",186209,93844,92365
"Daegu","2020","60-69 Years old",148216,76354,71862
"Daegu","2020","70-79 Years old",81304,42638,38666
"Daegu","2020","80 years and over",29957,15013,14944
"Daegu","2020","dead",9935,7640,2295
"Daegu","2021","Total",709100,375286,333814
"Daegu","2021","Under 30 years",11501,6488,5013
"Daegu","2021","30-39 Years old",70239,42795,27444
"Daegu","2021","40-49 Years old",155283,84875,70408
"Daegu","2021","50-59 Years old",186623,93572,93051
"Daegu","2021","60-69 Years old",158022,80038,77984
"Daegu","2021","70-79 Years old",83923,43418,40505
"Daegu","2021","80 years and over",33459,16442,17017
"Daegu","2021","dead",10050,7658,2392
"Daegu","2022","Total",717264,377734,339530
"Daegu","2022","Under 30 years",10505,5896,4609
"Daegu","2022","30-39 Years old",65316,39910,25406
"Daegu","2022","40-49 Years old",153519,84717,68802
"Daegu","2022","50-59 Years old",187803,94115,93688
"Daegu","2022","60-69 Years old",162878,81597,81281
"Daegu","2022","70-79 Years old",88265,44872,43393
"Daegu","2022","80 years and over",37956,18448,19508
"Daegu","2022","dead",11022,8179,2843
"Daegu","2023","Total",740776,389746,351030
"Daegu","2023","Under 30 years",9802,5432,4370
"Daegu","2023","30-39 Years old",63134,38900,24234
"Daegu","2023","40-49 Years old",151492,84645,66847
"Daegu","2023","50-59 Years old",192717,96595,96122
"Daegu","2023","60-69 Years old",172354,85949,86405
"Daegu","2023","70-79 Years old",94915,47632,47283
"Daegu","2023","80 years and over",43420,20956,22464
"Daegu","2023","dead",12942,9637,3305
"Incheon","2012","Total",677829,387338,290491
"Incheon","2012","Under 30 years",20233,10597,9636
"Incheon","2012","30-39 Years old",123261,72587,50674
"Incheon","2012","40-49 Years old",189263,106825,82438
"Incheon","2012","50-59 Years old",181695,104236,77459
"Incheon","2012","60-69 Years old",93734,53892,39842
"Incheon","2012","70-79 Years old",50054,26995,23059
"Incheon","2012","80 years and over",10920,5503,5417
"Incheon","2012","dead",8669,6703,1966
"Incheon","2013","Total",695488,394998,300490
"Incheon","2013","Under 30 years",17369,9122,8247
"Incheon","2013","30-39 Years old",118060,69695,48365
"Incheon","2013","40-49 Years old",190686,106835,83851
"Incheon","2013","50-59 Years old",192363,109157,83206
"Incheon","2013","60-69 Years old",99380,56770,42610
"Incheon","2013","70-79 Years old",55548,30009,25539
"Incheon","2013","80 years and over",13074,6437,6637
"Incheon","2013","dead",9008,6973,2035
"Incheon","2014","Total",709536,398844,310692
"Incheon","2014","Under 30 years",16256,8608,7648
"Incheon","2014","30-39 Years old",115609,68345,47264
"Incheon","2014","40-49 Years old",192712,107014,85698
"Incheon","2014","50-59 Years old",198227,110335,87892
"Incheon","2014","60-69 Years old",104903,59145,45758
"Incheon","2014","70-79 Years old",58255,31297,26958
"Incheon","2014","80 years and over",14116,6762,7354
"Incheon","2014","dead",9458,7338,2120
"Incheon","2015","Total",732615,407800,324815
"Incheon","2015","Under 30 years",17631,9343,8288
"Incheon","2015","30-39 Years old",116952,69416,47536
"Incheon","2015","40-49 Years old",193975,107129,86846
"Incheon","2015","50-59 Years old",204251,111512,92739
"Incheon","2015","60-69 Years old",114070,63318,50752
"Incheon","2015","70-79 Years old",60669,32359,28310
"Incheon","2015","80 years and over",16044,7717,8327
"Incheon","2015","dead",9023,7006,2017
"Incheon","2016","Total",746413,412015,334398
"Incheon","2016","Under 30 years",16665,8825,7840
"Incheon","2016","30-39 Years old",114762,68323,46439
"Incheon","2016","40-49 Years old",193511,106573,86938
"Incheon","2016","50-59 Years old",208113,111955,96158
"Incheon","2016","60-69 Years old",122140,66787,55353
"Incheon","2016","70-79 Years old",63441,33542,29899
"Incheon","2016","80 years and over",18449,8819,9630
"Incheon","2016","dead",9332,7191,2141
"Incheon","2017","Total",763252,417893,345359
"Incheon","2017","Under 30 years",16933,8882,8051
"Incheon","2017","30-39 Years old",112201,66904,45297
"Incheon","2017","40-49 Years old",194828,107368,87460
"Incheon","2017","50-59 Years old",212142,112254,99888
"Incheon","2017","60-69 Years old",129848,70196,59652
"Incheon","2017","70-79 Years old",68012,35700,32312
"Incheon","2017","80 years and over",20326,9706,10620
"Incheon","2017","dead",8962,6883,2079
"Incheon","2018","Total",780533,424105,356428
"Incheon","2018","Under 30 years",16910,8891,8019
"Incheon","2018","30-39 Years old",110551,65714,44837
"Incheon","2018","40-49 Years old",193674,107261,86413
"Incheon","2018","50-59 Years old",217411,113236,104175
"Incheon","2018","60-69 Years old",138325,73733,64592
"Incheon","2018","70-79 Years old",71445,37268,34177
"Incheon","2018","80 years and over",22881,10916,11965
"Incheon","2018","dead",9336,7086,2250
"Incheon","2019","Total",791488,427231,364257
"Incheon","2019","Under 30 years",15939,8310,7629
"Incheon","2019","30-39 Years old",104222,61754,42468
"Incheon","2019","40-49 Years old",192116,107171,84945
"Incheon","2019","50-59 Years old",220468,113625,106843
"Incheon","2019","60-69 Years old",148165,78043,70122
"Incheon","2019","70-79 Years old",75393,39077,36316
"Incheon","2019","80 years and over",25610,12084,13526
"Incheon","2019","dead",9575,7167,2408
"Incheon","2020","Total",803261,430338,372923
"Incheon","2020","Under 30 years",16330,8495,7835
"Incheon","2020","30-39 Years old",97222,57320,39902
"Incheon","2020","40-49 Years old",191658,107703,83955
"Incheon","2020","50-59 Years old",220019,112470,107549
"Incheon","2020","60-69 Years old",161266,83588,77678
"Incheon","2020","70-79 Years old",79230,40669,38561
"Incheon","2020","80 years and over",28088,13067,15021
"Incheon","2020","dead",9448,7026,2422
"Incheon","2021","Total",822999,438763,384236
"Incheon","2021","Under 30 years",18115,9502,8613
"Incheon","2021","30-39 Years old",94080,55353,38727
"Incheon","2021","40-49 Years old",190933,108199,82734
"Incheon","2021","50-59 Years old",220809,112511,108298
"Incheon","2021","60-69 Years old",177680,91095,86585
"Incheon","2021","70-79 Years old",81344,41228,40116
"Incheon","2021","80 years and over",31068,14273,16795
"Incheon","2021","dead",8970,6602,2368
"Incheon","2022","Total",839794,446044,393750
"Incheon","2022","Under 30 years",16719,8721,7998
"Incheon","2022","30-39 Years old",88634,51802,36832
"Incheon","2022","40-49 Years old",191443,109296,82147
"Incheon","2022","50-59 Years old",223227,113851,109376
"Incheon","2022","60-69 Years old",188317,95724,92593
"Incheon","2022","70-79 Years old",86226,43547,42679
"Incheon","2022","80 years and over",35294,15958,19336
"Incheon","2022","dead",9934,7145,2789
"Incheon","2023","Total",864282,458051,406231
"Incheon","2023","Under 30 years",14735,7692,7043
"Incheon","2023","30-39 Years old",86757,50468,36289
"Incheon","2023","40-49 Years old",192496,111156,81340
"Incheon","2023","50-59 Years old",226962,115789,111173
"Incheon","2023","60-69 Years old",201176,101431,99745
"Incheon","2023","70-79 Years old",91216,45793,45423
"Incheon","2023","80 years and over",39376,17578,21798
"Incheon","2023","dead",11564,8144,3420
"Gwangju","2012","Total",348858,192837,156021
"Gwangju","2012","Under 30 years",9569,5313,4256
"Gwangju","2012","30-39 Years old",64527,35484,29043
"Gwangju","2012","40-49 Years old",97662,51388,46274
"Gwangju","2012","50-59 Years old",81738,44784,36954
"Gwangju","2012","60-69 Years old",52507,30348,22159
"Gwangju","2012","70-79 Years old",30450,17275,13175
"Gwangju","2012","80 years and over",6499,3481,3018
"Gwangju","2012","dead",5906,4764,1142
"Gwangju","2013","Total",354659,194360,160299
"Gwangju","2013","Under 30 years",8331,4655,3676
"Gwangju","2013","30-39 Years old",61201,33945,27256
"Gwangju","2013","40-49 Years old",98997,51403,47594
"Gwangju","2013","50-59 Years old",85947,46417,39530
"Gwangju","2013","60-69 Years old",54104,30839,23265
"Gwangju","2013","70-79 Years old",32608,18342,14266
"Gwangju","2013","80 years and over",7371,3850,3521
"Gwangju","2013","dead",6100,4909,1191
"Gwangju","2014","Total",373513,203657,169856
"Gwangju","2014","Under 30 years",8254,4632,3622
"Gwangju","2014","30-39 Years old",61996,34757,27239
"Gwangju","2014","40-49 Years old",105032,54343,50689
"Gwangju","2014","50-59 Years old",92186,49296,42890
"Gwangju","2014","60-69 Years old",57399,32400,24999
"Gwangju","2014","70-79 Years old",34151,19002,15149
"Gwangju","2014","80 years and over",8144,4122,4022
"Gwangju","2014","dead",6351,5105,1246
"Gwangju","2015","Total",386295,208743,177552
"Gwangju","2015","Under 30 years",8715,4885,3830
"Gwangju","2015","30-39 Years old",62407,35597,26810
"Gwangju","2015","40-49 Years old",106943,54950,51993
"Gwangju","2015","50-59 Years old",95553,50154,45399
"Gwangju","2015","60-69 Years old",61440,33767,27673
"Gwangju","2015","70-79 Years old",35923,19889,16034
"Gwangju","2015","80 years and over",9260,4671,4589
"Gwangju","2015","dead",6054,4830,1224
"Gwangju","2016","Total",393535,211029,182506
"Gwangju","2016","Under 30 years",8066,4546,3520
"Gwangju","2016","30-39 Years old",59862,34404,25458
"Gwangju","2016","40-49 Years old",107212,54958,52254
"Gwangju","2016","50-59 Years old",99482,51413,48069
"Gwangju","2016","60-69 Years old",64460,34778,29682
"Gwangju","2016","70-79 Years old",37600,20656,16944
"Gwangju","2016","80 years and over",10707,5381,5326
"Gwangju","2016","dead",6146,4893,1253
"Gwangju","2017","Total",399189,212848,186341
"Gwangju","2017","Under 30 years",7966,4459,3507
"Gwangju","2017","30-39 Years old",57105,33168,23937
"Gwangju","2017","40-49 Years old",107398,55154,52244
"Gwangju","2017","50-59 Years old",101452,51701,49751
"Gwangju","2017","60-69 Years old",67059,35730,31329
"Gwangju","2017","70-79 Years old",40068,21763,18305
"Gwangju","2017","80 years and over",11884,5918,5966
"Gwangju","2017","dead",6257,4955,1302
"Gwangju","2018","Total",406703,214953,191750
"Gwangju","2018","Under 30 years",8465,4743,3722
"Gwangju","2018","30-39 Years old",56703,33203,23500
"Gwangju","2018","40-49 Years old",105963,54653,51310
"Gwangju","2018","50-59 Years old",104883,52503,52380
"Gwangju","2018","60-69 Years old",69594,36249,33345
"Gwangju","2018","70-79 Years old",41916,22381,19535
"Gwangju","2018","80 years and over",13217,6565,6652
"Gwangju","2018","dead",5962,4656,1306
"Gwangju","2019","Total",414198,217349,196849
"Gwangju","2019","Under 30 years",8522,4762,3760
"Gwangju","2019","30-39 Years old",54170,31893,22277
"Gwangju","2019","40-49 Years old",105585,54868,50717
"Gwangju","2019","50-59 Years old",107579,53267,54312
"Gwangju","2019","60-69 Years old",73588,37616,35972
"Gwangju","2019","70-79 Years old",44173,23144,21029
"Gwangju","2019","80 years and over",14901,7375,7526
"Gwangju","2019","dead",5680,4424,1256
"Gwangju","2020","Total",419407,218556,200851
"Gwangju","2020","Under 30 years",8512,4686,3826
"Gwangju","2020","30-39 Years old",50792,29932,20860
"Gwangju","2020","40-49 Years old",104631,54734,49897
"Gwangju","2020","50-59 Years old",107970,53042,54928
"Gwangju","2020","60-69 Years old",78791,39598,39193
"Gwangju","2020","70-79 Years old",46019,23825,22194
"Gwangju","2020","80 years and over",16651,8123,8528
"Gwangju","2020","dead",6041,4616,1425
"Gwangju","2021","Total",430443,222863,207580
"Gwangju","2021","Under 30 years",9260,5088,4172
"Gwangju","2021","30-39 Years old",49538,29331,20207
"Gwangju","2021","40-49 Years old",104279,55223,49056
"Gwangju","2021","50-59 Years old",111066,54160,56906
"Gwangju","2021","60-69 Years old",84374,41478,42896
"Gwangju","2021","70-79 Years old",47463,24172,23291
"Gwangju","2021","80 years and over",18664,9012,9652
"Gwangju","2021","dead",5799,4399,1400
"Gwangju","2022","Total",436853,225185,211668
"Gwangju","2022","Under 30 years",8928,4819,4109
"Gwangju","2022","30-39 Years old",46778,27743,19035
"Gwangju","2022","40-49 Years old",103348,55439,47909
"Gwangju","2022","50-59 Years old",113932,55413,58519
"Gwangju","2022","60-69 Years old",87557,42529,45028
"Gwangju","2022","70-79 Years old",48912,24470,24442
"Gwangju","2022","80 years and over",21481,10358,11123
"Gwangju","2022","dead",5917,4414,1503
"Gwangju","2023","Total",443367,227412,215955
"Gwangju","2023","Under 30 years",8268,4454,3814
"Gwangju","2023","30-39 Years old",44358,26281,18077
"Gwangju","2023","40-49 Years old",101839,55506,46333
"Gwangju","2023","50-59 Years old",116613,56571,60042
"Gwangju","2023","60-69 Years old",92269,44231,48038
"Gwangju","2023","70-79 Years old",50861,24935,25926
"Gwangju","2023","80 years and over",23294,11087,12207
"Gwangju","2023","dead",5865,4347,1518
"Daejeon","2012","Total",359070,206642,152428
"Daejeon","2012","Under 30 years",9047,5059,3988
"Daejeon","2012","30-39 Years old",63974,36310,27664
"Daejeon","2012","40-49 Years old",100457,56695,43762
"Daejeon","2012","50-59 Years old",95804,55415,40389
"Daejeon","2012","60-69 Years old",51609,30602,21007
"Daejeon","2012","70-79 Years old",28486,16353,12133
"Daejeon","2012","80 years and over",5993,3256,2737
"Daejeon","2012","dead",3700,2952,748
"Daejeon","2013","Total",366120,208817,157303
"Daejeon","2013","Under 30 years",7962,4491,3471
"Daejeon","2013","30-39 Years old",60891,34409,26482
"Daejeon","2013","40-49 Years old",102219,56958,45261
"Daejeon","2013","50-59 Years old",99050,56571,42479
"Daejeon","2013","60-69 Years old",54267,31891,22376
"Daejeon","2013","70-79 Years old",30873,17639,13234
"Daejeon","2013","80 years and over",6940,3731,3209
"Daejeon","2013","dead",3918,3127,791
"Daejeon","2014","Total",380020,215380,164640
"Daejeon","2014","Under 30 years",7841,4456,3385
"Daejeon","2014","30-39 Years old",60169,34222,25947
"Daejeon","2014","40-49 Years old",106227,58811,47416
"Daejeon","2014","50-59 Years old",102718,58002,44716
"Daejeon","2014","60-69 Years old",58302,33889,24413
"Daejeon","2014","70-79 Years old",32776,18606,14170
"Daejeon","2014","80 years and over",7832,4084,3748
"Daejeon","2014","dead",4155,3310,845
"Daejeon","2015","Total",391520,219531,171989
"Daejeon","2015","Under 30 years",8237,4695,3542
"Daejeon","2015","30-39 Years old",59323,33874,25449
"Daejeon","2015","40-49 Years old",107544,59034,48510
"Daejeon","2015","50-59 Years old",104738,57898,46840
"Daejeon","2015","60-69 Years old",63858,36531,27327
"Daejeon","2015","70-79 Years old",34584,19491,15093
"Daejeon","2015","80 years and over",9227,4839,4388
"Daejeon","2015","dead",4009,3169,840
"Daejeon","2016","Total",395168,219542,175626
"Daejeon","2016","Under 30 years",7469,4273,3196
"Daejeon","2016","30-39 Years old",56647,32669,23978
"Daejeon","2016","40-49 Years old",107383,58371,49012
"Daejeon","2016","50-59 Years old",105318,57305,48013
"Daejeon","2016","60-69 Years old",68089,38354,29735
"Daejeon","2016","70-79 Years old",35675,19909,15766
"Daejeon","2016","80 years and over",10576,5483,5093
"Daejeon","2016","dead",4011,3178,833
"Daejeon","2017","Total",394868,217981,176887
"Daejeon","2017","Under 30 years",7142,4096,3046
"Daejeon","2017","30-39 Years old",52047,30216,21831
"Daejeon","2017","40-49 Years old",105453,57063,48390
"Daejeon","2017","50-59 Years old",104986,56349,48637
"Daejeon","2017","60-69 Years old",71603,40030,31573
"Daejeon","2017","70-79 Years old",37610,20800,16810
"Daejeon","2017","80 years and over",11834,6132,5702
"Daejeon","2017","dead",4193,3295,898
"Daejeon","2018","Total",402344,219888,182456
"Daejeon","2018","Under 30 years",7282,4100,3182
"Daejeon","2018","30-39 Years old",51337,29993,21344
"Daejeon","2018","40-49 Years old",103574,55868,47706
"Daejeon","2018","50-59 Years old",107625,56759,50866
"Daejeon","2018","60-69 Years old",75127,41270,33857
"Daejeon","2018","70-79 Years old",39704,21652,18052
"Daejeon","2018","80 years and over",13484,6971,6513
"Daejeon","2018","dead",4211,3275,936
"Daejeon","2019","Total",404201,219331,184870
"Daejeon","2019","Under 30 years",6983,3883,3100
"Daejeon","2019","30-39 Years old",47835,28041,19794
"Daejeon","2019","40-49 Years old",100630,54428,46202
"Daejeon","2019","50-59 Years old",108958,57002,51956
"Daejeon","2019","60-69 Years old",78809,42453,36356
"Daejeon","2019","70-79 Years old",41447,22388,19059
"Daejeon","2019","80 years and over",15119,7745,7374
"Daejeon","2019","dead",4420,3391,1029
"Daejeon","2020","Total",410730,220324,190406
"Daejeon","2020","Under 30 years",7698,4250,3448
"Daejeon","2020","30-39 Years old",45973,26758,19215
"Daejeon","2020","40-49 Years old",99515,53625,45890
"Daejeon","2020","50-59 Years old",109112,56710,52402
"Daejeon","2020","60-69 Years old",83907,44182,39725
"Daejeon","2020","70-79 Years old",43716,23235,20481
"Daejeon","2020","80 years and over",16465,8269,8196
"Daejeon","2020","dead",4344,3295,1049
"Daejeon","2021","Total",418833,222952,195881
"Daejeon","2021","Under 30 years",8595,4671,3924
"Daejeon","2021","30-39 Years old",44516,26017,18499
"Daejeon","2021","40-49 Years old",97430,52575,44855
"Daejeon","2021","50-59 Years old",109965,56792,53173
"Daejeon","2021","60-69 Years old",90860,47018,43842
"Daejeon","2021","70-79 Years old",45094,23747,21347
"Daejeon","2021","80 years and over",18164,8989,9175
"Daejeon","2021","dead",4209,3143,1066
"Daejeon","2022","Total",425773,225651,200122
"Daejeon","2022","Under 30 years",8156,4405,3751
"Daejeon","2022","30-39 Years old",42432,24843,17589
"Daejeon","2022","40-49 Years old",96605,52431,44174
"Daejeon","2022","50-59 Years old",111527,57515,54012
"Daejeon","2022","60-69 Years old",94747,48493,46254
"Daejeon","2022","70-79 Years old",46827,24373,22454
"Daejeon","2022","80 years and over",20784,10167,10617
"Daejeon","2022","dead",4695,3424,1271
"Daejeon","2023","Total",433503,229165,204338
"Daejeon","2023","Under 30 years",7519,4071,3448
"Daejeon","2023","30-39 Years old",41159,24106,17053
"Daejeon","2023","40-49 Years old",95104,52190,42914
"Daejeon","2023","50-59 Years old",114589,58972,55617
"Daejeon","2023","60-69 Years old",98302,49967,48335
"Daejeon","2023","70-79 Years old",49248,25439,23809
"Daejeon","2023","80 years and over",22550,10808,11742
"Daejeon","2023","dead",5032,3612,1420
"Ulsan","2012","Total",291434,180908,110526
"Ulsan","2012","Under 30 years",7736,4667,3069
"Ulsan","2012","30-39 Years old",55821,34552,21269
"Ulsan","2012","40-49 Years old",87673,53296,34377
"Ulsan","2012","50-59 Years old",81521,51670,29851
"Ulsan","2012","60-69 Years old",37214,23654,13560
"Ulsan","2012","70-79 Years old",15534,9117,6417
"Ulsan","2012","80 years and over",2733,1400,1333
"Ulsan","2012","dead",3202,2552,650
"Ulsan","2013","Total",301663,185327,116336
"Ulsan","2013","Under 30 years",6941,4238,2703
"Ulsan","2013","30-39 Years old",55216,34549,20667
"Ulsan","2013","40-49 Years old",88415,52554,35861
"Ulsan","2013","50-59 Years old",86721,54093,32628
"Ulsan","2013","60-69 Years old",40383,25398,14985
"Ulsan","2013","70-79 Years old",17378,10170,7208
"Ulsan","2013","80 years and over",3232,1637,1595
"Ulsan","2013","dead",3377,2688,689
"Ulsan","2014","Total",311549,189958,121591
"Ulsan","2014","Under 30 years",6600,4145,2455
"Ulsan","2014","30-39 Years old",55767,35277,20490
"Ulsan","2014","40-49 Years old",90026,52763,37263
"Ulsan","2014","50-59 Years old",90448,55428,35020
"Ulsan","2014","60-69 Years old",43346,27133,16213
"Ulsan","2014","70-79 Years old",18221,10553,7668
"Ulsan","2014","80 years and over",3520,1783,1737
"Ulsan","2014","dead",3621,2876,745
"Ulsan","2015","Total",325450,196542,128908
"Ulsan","2015","Under 30 years",7345,4668,2677
"Ulsan","2015","30-39 Years old",57793,37163,20630
"Ulsan","2015","40-49 Years old",90150,52026,38124
"Ulsan","2015","50-59 Years old",94702,56912,37790
"Ulsan","2015","60-69 Years old",48320,29690,18630
"Ulsan","2015","70-79 Years old",19545,11223,8322
"Ulsan","2015","80 years and over",4040,2039,2001
"Ulsan","2015","dead",3555,2821,734
"Ulsan","2016","Total",331064,198577,132487
"Ulsan","2016","Under 30 years",6763,4277,2486
"Ulsan","2016","30-39 Years old",57133,37033,20100
"Ulsan","2016","40-49 Years old",88427,50614,37813
"Ulsan","2016","50-59 Years old",97254,57768,39486
"Ulsan","2016","60-69 Years old",52624,31891,20733
"Ulsan","2016","70-79 Years old",20530,11762,8768
"Ulsan","2016","80 years and over",4672,2332,2340
"Ulsan","2016","dead",3661,2900,761
"Ulsan","2017","Total",338232,202151,136081
"Ulsan","2017","Under 30 years",6620,4200,2420
"Ulsan","2017","30-39 Years old",55865,36496,19369
"Ulsan","2017","40-49 Years old",88118,50689,37429
"Ulsan","2017","50-59 Years old",99521,58482,41039
"Ulsan","2017","60-69 Years old",56785,33937,22848
"Ulsan","2017","70-79 Years old",22455,12875,9580
"Ulsan","2017","80 years and over",5251,2632,2619
"Ulsan","2017","dead",3617,2840,777
"Ulsan","2018","Total",343884,204605,139279
"Ulsan","2018","Under 30 years",6484,4095,2389
"Ulsan","2018","30-39 Years old",54574,35866,18708
"Ulsan","2018","40-49 Years old",86770,50233,36537
"Ulsan","2018","50-59 Years old",102061,59217,42844
"Ulsan","2018","60-69 Years old",60336,35544,24792
"Ulsan","2018","70-79 Years old",24095,13849,10246
"Ulsan","2018","80 years and over",5755,2834,2921
"Ulsan","2018","dead",3809,2967,842
"Ulsan","2019","Total",351519,208416,143103
"Ulsan","2019","Under 30 years",5838,3582,2256
"Ulsan","2019","30-39 Years old",51607,34040,17567
"Ulsan","2019","40-49 Years old",86443,50513,35930
"Ulsan","2019","50-59 Years old",104087,59803,44284
"Ulsan","2019","60-69 Years old",65819,38438,27381
"Ulsan","2019","70-79 Years old",26645,15361,11284
"Ulsan","2019","80 years and over",6916,3472,3444
"Ulsan","2019","dead",4164,3207,957
"Ulsan","2020","Total",358845,211198,147647
"Ulsan","2020","Under 30 years",6266,3819,2447
"Ulsan","2020","30-39 Years old",49085,32367,16718
"Ulsan","2020","40-49 Years old",87153,51387,35766
"Ulsan","2020","50-59 Years old",104114,59064,45050
"Ulsan","2020","60-69 Years old",71695,41197,30498
"Ulsan","2020","70-79 Years old",28610,16365,12245
"Ulsan","2020","80 years and over",7854,3920,3934
"Ulsan","2020","dead",4068,3079,989
"Ulsan","2021","Total",361641,211574,150067
"Ulsan","2021","Under 30 years",6334,3878,2456
"Ulsan","2021","30-39 Years old",45286,29639,15647
"Ulsan","2021","40-49 Years old",85807,51131,34676
"Ulsan","2021","50-59 Years old",102864,57874,44990
"Ulsan","2021","60-69 Years old",77854,44175,33679
"Ulsan","2021","70-79 Years old",30628,17443,13185
"Ulsan","2021","80 years and over",8782,4352,4430
"Ulsan","2021","dead",4086,3082,1004
"Ulsan","2022","Total",363002,211411,151591
"Ulsan","2022","Under 30 years",5692,3455,2237
"Ulsan","2022","30-39 Years old",40966,26874,14092
"Ulsan","2022","40-49 Years old",84819,51089,33730
"Ulsan","2022","50-59 Years old",101822,56816,45006
"Ulsan","2022","60-69 Years old",82197,46296,35901
"Ulsan","2022","70-79 Years old",33139,18717,14422
"Ulsan","2022","80 years and over",10226,5072,5154
"Ulsan","2022","dead",4141,3092,1049
"Ulsan","2023","Total",364550,211582,152968
"Ulsan","2023","Under 30 years",4759,2900,1859
"Ulsan","2023","30-39 Years old",36810,24162,12648
"Ulsan","2023","40-49 Years old",82728,50406,32322
"Ulsan","2023","50-59 Years old",101611,56279,45332
"Ulsan","2023","60-69 Years old",86540,48558,37982
"Ulsan","2023","70-79 Years old",35819,20129,15690
"Ulsan","2023","80 years and over",11585,5714,5871
"Ulsan","2023","dead",4698,3434,1264
"Sejong","2012","Total",27165,17277,9888
"Sejong","2012","Under 30 years",515,332,183
"Sejong","2012","30-39 Years old",4437,2738,1699
"Sejong","2012","40-49 Years old",6026,3841,2185
"Sejong","2012","50-59 Years old",6331,3953,2378
"Sejong","2012","60-69 Years old",4451,2756,1695
"Sejong","2012","70-79 Years old",3434,2176,1258
"Sejong","2012","80 years and over",921,567,354
"Sejong","2012","dead",1050,914,136
"Sejong","2013","Total",29421,18605,10816
"Sejong","2013","Under 30 years",522,332,190
"Sejong","2013","30-39 Years old",4489,2704,1785
"Sejong","2013","40-49 Years old",6840,4335,2505
"Sejong","2013","50-59 Years old",6861,4275,2586
"Sejong","2013","60-69 Years old",4757,2944,1813
"Sejong","2013","70-79 Years old",3679,2316,1363
"Sejong","2013","80 years and over",1100,672,428
"Sejong","2013","dead",1173,1027,146
"Sejong","2014","Total",33459,20745,12714
"Sejong","2014","Under 30 years",718,455,263
"Sejong","2014","30-39 Years old",5462,3244,2218
"Sejong","2014","40-49 Years old",8656,5393,3263
"Sejong","2014","50-59 Years old",7531,4556,2975
"Sejong","2014","60-69 Years old",5014,3062,1952
"Sejong","2014","70-79 Years old",3711,2278,1433
"Sejong","2014","80 years and over",1081,630,451
"Sejong","2014","dead",1286,1127,159
"Sejong","2015","Total",49659,29836,19823
"Sejong","2015","Under 30 years",1088,645,443
"Sejong","2015","30-39 Years old",10896,6363,4533
"Sejong","2015","40-49 Years old",14642,8919,5723
"Sejong","2015","50-59 Years old",10360,6014,4346
"Sejong","2015","60-69 Years old",6340,3760,2580
"Sejong","2015","70-79 Years old",3869,2356,1513
"Sejong","2015","80 years and over",1197,679,518
"Sejong","2015","dead",1267,1100,167
"Sejong","2016","Total",58322,34585,23737
"Sejong","2016","Under 30 years",1180,677,503
"Sejong","2016","30-39 Years old",12708,7529,5179
"Sejong","2016","40-49 Years old",17907,10751,7156
"Sejong","2016","50-59 Years old",12040,6832,5208
"Sejong","2016","60-69 Years old",7664,4403,3261
"Sejong","2016","70-79 Years old",4119,2439,1680
"Sejong","2016","80 years and over",1402,810,592
"Sejong","2016","dead",1302,1144,158
"Sejong","2017","Total",69759,40737,29022
"Sejong","2017","Under 30 years",1358,751,607
"Sejong","2017","30-39 Years old",15073,8753,6320
"Sejong","2017","40-49 Years old",22006,13042,8964
"Sejong","2017","50-59 Years old",14480,8099,6381
"Sejong","2017","60-69 Years old",9177,5205,3972
"Sejong","2017","70-79 Years old",4656,2742,1914
"Sejong","2017","80 years and over",1645,947,698
"Sejong","2017","dead",1364,1198,166
"Sejong","2018","Total",81225,46831,34394
"Sejong","2018","Under 30 years",1650,879,771
"Sejong","2018","30-39 Years old",17609,10190,7419
"Sejong","2018","40-49 Years old",25735,15056,10679
"Sejong","2018","50-59 Years old",17179,9488,7691
"Sejong","2018","60-69 Years old",10749,6026,4723
"Sejong","2018","70-79 Years old",5072,2915,2157
"Sejong","2018","80 years and over",1890,1115,775
"Sejong","2018","dead",1341,1162,179
"Sejong","2019","Total",87537,50056,37481
"Sejong","2019","Under 30 years",1566,806,760
"Sejong","2019","30-39 Years old",17343,10010,7333
"Sejong","2019","40-49 Years old",28177,16366,11811
"Sejong","2019","50-59 Years old",19373,10648,8725
"Sejong","2019","60-69 Years old",12027,6635,5392
"Sejong","2019","70-79 Years old",5509,3148,2361
"Sejong","2019","80 years and over",2127,1223,904
"Sejong","2019","dead",1415,1220,195
"Sejong","2020","Total",93116,52776,40340
"Sejong","2020","Under 30 years",1671,859,812
"Sejong","2020","30-39 Years old",16913,9561,7352
"Sejong","2020","40-49 Years old",30303,17468,12835
"Sejong","2020","50-59 Years old",21043,11623,9420
"Sejong","2020","60-69 Years old",13402,7299,6103
"Sejong","2020","70-79 Years old",5987,3387,2600
"Sejong","2020","80 years and over",2292,1300,992
"Sejong","2020","dead",1505,1279,226
"Sejong","2021","Total",99104,55730,43374
"Sejong","2021","Under 30 years",1793,940,853
"Sejong","2021","30-39 Years old",16371,9169,7202
"Sejong","2021","40-49 Years old",31995,18298,13697
"Sejong","2021","50-59 Years old",23097,12788,10309
"Sejong","2021","60-69 Years old",15471,8312,7159
"Sejong","2021","70-79 Years old",6277,3513,2764
"Sejong","2021","80 years and over",2530,1389,1141
"Sejong","2021","dead",1570,1321,249
"Sejong","2022","Total",113799,63267,50532
"Sejong","2022","Under 30 years",2151,1024,1127
"Sejong","2022","30-39 Years old",19119,10501,8618
"Sejong","2022","40-49 Years old",36987,20980,16007
"Sejong","2022","50-59 Years old",26680,14823,11857
"Sejong","2022","60-69 Years old",17345,9222,8123
"Sejong","2022","70-79 Years old",7070,3881,3189
"Sejong","2022","80 years and over",2886,1564,1322
"Sejong","2022","dead",1561,1272,289
"Sejong","2023","Total",119296,66130,53166
"Sejong","2023","Under 30 years",1926,959,967
"Sejong","2023","30-39 Years old",18889,10335,8554
"Sejong","2023","40-49 Years old",38697,21788,16909
"Sejong","2023","50-59 Years old",28982,16218,12764
"Sejong","2023","60-69 Years old",18633,9834,8799
"Sejong","2023","70-79 Years old",7539,4108,3431
"Sejong","2023","80 years and over",3067,1612,1455
"Sejong","2023","dead",1563,1276,287
"Gyeonggi-do","2012","Total",2723040,1574029,1149011
"Gyeonggi-do","2012","Under 30 years",65753,35235,30518
"Gyeonggi-do","2012","30-39 Years old",503531,292361,211170
"Gyeonggi-do","2012","40-49 Years old",813424,471653,341771
"Gyeonggi-do","2012","50-59 Years old",690802,406513,284289
"Gyeonggi-do","2012","60-69 Years old",366191,208100,158091
"Gyeonggi-do","2012","70-79 Years old",211918,116478,95440
"Gyeonggi-do","2012","80 years and over",44647,22986,21661
"Gyeonggi-do","2012","dead",26774,20703,6071
"Gyeonggi-do","2013","Total",2816567,1615124,1201443
"Gyeonggi-do","2013","Under 30 years",59297,31809,27488
"Gyeonggi-do","2013","30-39 Years old",486727,281969,204758
"Gyeonggi-do","2013","40-49 Years old",834748,477979,356769
"Gyeonggi-do","2013","50-59 Years old",737938,429215,308723
"Gyeonggi-do","2013","60-69 Years old",387244,219433,167811
"Gyeonggi-do","2013","70-79 Years old",230108,125915,104193
"Gyeonggi-do","2013","80 years and over",52281,26877,25404
"Gyeonggi-do","2013","dead",28224,21927,6297
"Gyeonggi-do","2014","Total",2880735,1639115,1241620
"Gyeonggi-do","2014","Under 30 years",56222,30106,26116
"Gyeonggi-do","2014","30-39 Years old",474081,275964,198117
"Gyeonggi-do","2014","40-49 Years old",851111,482304,368807
"Gyeonggi-do","2014","50-59 Years old",764786,438104,326682
"Gyeonggi-do","2014","60-69 Years old",406636,229417,177219
"Gyeonggi-do","2014","70-79 Years old",239880,130238,109642
"Gyeonggi-do","2014","80 years and over",58051,29612,28439
"Gyeonggi-do","2014","dead",29968,23370,6598
"Gyeonggi-do","2015","Total",2991332,1684388,1306944
"Gyeonggi-do","2015","Under 30 years",63488,33968,29520
"Gyeonggi-do","2015","30-39 Years old",476065,278319,197746
"Gyeonggi-do","2015","40-49 Years old",864535,484546,379989
"Gyeonggi-do","2015","50-59 Years old",795506,447214,348292
"Gyeonggi-do","2015","60-69 Years old",443792,247687,196105
"Gyeonggi-do","2015","70-79 Years old",251371,135648,115723
"Gyeonggi-do","2015","80 years and over",66941,33988,32953
"Gyeonggi-do","2015","dead",29634,23018,6616
"Gyeonggi-do","2016","Total",3069755,1714341,1355414
"Gyeonggi-do","2016","Under 30 years",59230,31778,27452
"Gyeonggi-do","2016","30-39 Years old",468382,274719,193663
"Gyeonggi-do","2016","40-49 Years old",871115,485429,385686
"Gyeonggi-do","2016","50-59 Years old",823191,455790,367401
"Gyeonggi-do","2016","60-69 Years old",476876,263034,213842
"Gyeonggi-do","2016","70-79 Years old",262385,140260,122125
"Gyeonggi-do","2016","80 years and over",77242,39010,38232
"Gyeonggi-do","2016","dead",31334,24321,7013
"Gyeonggi-do","2017","Total",3169606,1760672,1408934
"Gyeonggi-do","2017","Under 30 years",60698,32656,28042
"Gyeonggi-do","2017","30-39 Years old",465594,274381,191213
"Gyeonggi-do","2017","40-49 Years old",884609,493345,391264
"Gyeonggi-do","2017","50-59 Years old",850350,463564,386786
"Gyeonggi-do","2017","60-69 Years old",508833,278603,230230
"Gyeonggi-do","2017","70-79 Years old",280421,149268,131153
"Gyeonggi-do","2017","80 years and over",86868,43941,42927
"Gyeonggi-do","2017","dead",32233,24914,7319
"Gyeonggi-do","2018","Total",3307703,1823763,1483940
"Gyeonggi-do","2018","Under 30 years",63450,34062,29388
"Gyeonggi-do","2018","30-39 Years old",477730,281349,196381
"Gyeonggi-do","2018","40-49 Years old",897411,501193,396218
"Gyeonggi-do","2018","50-59 Years old",891234,478096,413138
"Gyeonggi-do","2018","60-69 Years old",549564,298135,251429
"Gyeonggi-do","2018","70-79 Years old",296854,156216,140638
"Gyeonggi-do","2018","80 years and over",98123,49323,48800
"Gyeonggi-do","2018","dead",33337,25389,7948
"Gyeonggi-do","2019","Total",3454042,1891708,1562334
"Gyeonggi-do","2019","Under 30 years",63548,33719,29829
"Gyeonggi-do","2019","30-39 Years old",480297,282760,197537
"Gyeonggi-do","2019","40-49 Years old",917841,514574,403267
"Gyeonggi-do","2019","50-59 Years old",934583,494963,439620
"Gyeonggi-do","2019","60-69 Years old",599783,321885,277898
"Gyeonggi-do","2019","70-79 Years old",313485,163221,150264
"Gyeonggi-do","2019","80 years and over",110996,55267,55729
"Gyeonggi-do","2019","dead",33509,25319,8190
"Gyeonggi-do","2020","Total",3587339,1949089,1638250
"Gyeonggi-do","2020","Under 30 years",69823,37199,32624
"Gyeonggi-do","2020","30-39 Years old",469018,274536,194482
"Gyeonggi-do","2020","40-49 Years old",934595,525139,409456
"Gyeonggi-do","2020","50-59 Years old",964462,505396,459066
"Gyeonggi-do","2020","60-69 Years old",662507,350987,311520
"Gyeonggi-do","2020","70-79 Years old",329929,170018,159911
"Gyeonggi-do","2020","80 years and over",123602,60839,62763
"Gyeonggi-do","2020","dead",33403,24975,8428
"Gyeonggi-do","2021","Total",3732021,2016017,1716004
"Gyeonggi-do","2021","Under 30 years",78637,42068,36569
"Gyeonggi-do","2021","30-39 Years old",466687,271092,195595
"Gyeonggi-do","2021","40-49 Years old",943905,533634,410271
"Gyeonggi-do","2021","50-59 Years old",994709,519227,475482
"Gyeonggi-do","2021","60-69 Years old",735621,384727,350894
"Gyeonggi-do","2021","70-79 Years old",340720,173635,167085
"Gyeonggi-do","2021","80 years and over",138360,67052,71308
"Gyeonggi-do","2021","dead",33382,24582,8800
"Gyeonggi-do","2022","Total",3815559,2054048,1761511
"Gyeonggi-do","2022","Under 30 years",73223,38906,34317
"Gyeonggi-do","2022","30-39 Years old",438874,253449,185425
"Gyeonggi-do","2022","40-49 Years old",946142,538007,408135
"Gyeonggi-do","2022","50-59 Years old",1023090,533944,489146
"Gyeonggi-do","2022","60-69 Years old",778984,404733,374251
"Gyeonggi-do","2022","70-79 Years old",361105,183132,177973
"Gyeonggi-do","2022","80 years and over",156804,74953,81851
"Gyeonggi-do","2022","dead",37337,26924,10413
"Gyeonggi-do","2023","Total",3944046,2117116,1826930
"Gyeonggi-do","2023","Under 30 years",67407,35752,31655
"Gyeonggi-do","2023","30-39 Years old",435774,250784,184990
"Gyeonggi-do","2023","40-49 Years old",955457,547332,408125
"Gyeonggi-do","2023","50-59 Years old",1058810,552486,506324
"Gyeonggi-do","2023","60-69 Years old",834396,430957,403439
"Gyeonggi-do","2023","70-79 Years old",383115,192808,190307
"Gyeonggi-do","2023","80 years and over",172445,80841,91604
"Gyeonggi-do","2023","dead",36642,26156,10486
"Gangwon State","2012","Total",361897,216477,145420
"Gangwon State","2012","Under 30 years",7545,4483,3062
"Gangwon State","2012","30-39 Years old",44883,25505,19378
"Gangwon State","2012","40-49 Years old",81527,46686,34841
"Gangwon State","2012","50-59 Years old",98347,58626,39721
"Gangwon State","2012","60-69 Years old",64147,38750,25397
"Gangwon State","2012","70-79 Years old",45341,27683,17658
"Gangwon State","2012","80 years and over",9844,5770,4074
"Gangwon State","2012","dead",10263,8974,1289
"Gangwon State","2013","Total",378828,224857,153971
"Gangwon State","2013","Under 30 years",6874,4143,2731
"Gangwon State","2013","30-39 Years old",43638,24872,18766
"Gangwon State","2013","40-49 Years old",83067,47110,35957
"Gangwon State","2013","50-59 Years old",103992,61257,42735
"Gangwon State","2013","60-69 Years old",68012,40633,27379
"Gangwon State","2013","70-79 Years old",50611,30487,20124
"Gangwon State","2013","80 years and over",11535,6647,4888
"Gangwon State","2013","dead",11099,9708,1391
"Gangwon State","2014","Total",384092,226414,157678
"Gangwon State","2014","Under 30 years",6469,3996,2473
"Gangwon State","2014","30-39 Years old",42167,24253,17914
"Gangwon State","2014","40-49 Years old",84058,47228,36830
"Gangwon State","2014","50-59 Years old",103694,60167,43527
"Gangwon State","2014","60-69 Years old",70346,41727,28619
"Gangwon State","2014","70-79 Years old",52489,31225,21264
"Gangwon State","2014","80 years and over",12139,6664,5475
"Gangwon State","2014","dead",12730,11154,1576
"Gangwon State","2015","Total",395250,229969,165281
"Gangwon State","2015","Under 30 years",8320,5080,3240
"Gangwon State","2015","30-39 Years old",43028,24928,18100
"Gangwon State","2015","40-49 Years old",85919,47861,38058
"Gangwon State","2015","50-59 Years old",104741,59500,45241
"Gangwon State","2015","60-69 Years old",74114,43328,30786
"Gangwon State","2015","70-79 Years old",53548,31473,22075
"Gangwon State","2015","80 years and over",13590,7341,6249
"Gangwon State","2015","dead",11990,10458,1532
"Gangwon State","2016","Total",407573,235437,172136
"Gangwon State","2016","Under 30 years",7127,4318,2809
"Gangwon State","2016","30-39 Years old",42430,24836,17594
"Gangwon State","2016","40-49 Years old",85640,47420,38220
"Gangwon State","2016","50-59 Years old",107049,59915,47134
"Gangwon State","2016","60-69 Years old",80489,46636,33853
"Gangwon State","2016","70-79 Years old",55933,32495,23438
"Gangwon State","2016","80 years and over",16097,8714,7383
"Gangwon State","2016","dead",12808,11103,1705
"Gangwon State","2017","Total",416492,239480,177012
"Gangwon State","2017","Under 30 years",7078,4270,2808
"Gangwon State","2017","30-39 Years old",40809,24112,16697
"Gangwon State","2017","40-49 Years old",85455,47214,38241
"Gangwon State","2017","50-59 Years old",107196,59107,48089
"Gangwon State","2017","60-69 Years old",86022,49631,36391
"Gangwon State","2017","70-79 Years old",58470,33765,24705
"Gangwon State","2017","80 years and over",18292,10006,8286
"Gangwon State","2017","dead",13170,11375,1795
"Gangwon State","2018","Total",426399,243015,183384
"Gangwon State","2018","Under 30 years",7172,4347,2825
"Gangwon State","2018","30-39 Years old",40290,23961,16329
"Gangwon State","2018","40-49 Years old",84496,46592,37904
"Gangwon State","2018","50-59 Years old",109058,59179,49879
"Gangwon State","2018","60-69 Years old",91602,52359,39243
"Gangwon State","2018","70-79 Years old",59911,34118,25793
"Gangwon State","2018","80 years and over",21177,11652,9525
"Gangwon State","2018","dead",12693,10807,1886
"Gangwon State","2019","Total",440683,248979,191704
"Gangwon State","2019","Under 30 years",7283,4362,2921
"Gangwon State","2019","30-39 Years old",40833,24402,16431
"Gangwon State","2019","40-49 Years old",85155,46874,38281
"Gangwon State","2019","50-59 Years old",111583,59812,51771
"Gangwon State","2019","60-69 Years old",98790,55681,43109
"Gangwon State","2019","70-79 Years old",60576,34143,26433
"Gangwon State","2019","80 years and over",23682,12921,10761
"Gangwon State","2019","dead",12781,10784,1997
"Gangwon State","2020","Total",459542,257233,202309
"Gangwon State","2020","Under 30 years",7724,4603,3121
"Gangwon State","2020","30-39 Years old",41717,25143,16574
"Gangwon State","2020","40-49 Years old",87067,47785,39282
"Gangwon State","2020","50-59 Years old",113661,60282,53379
"Gangwon State","2020","60-69 Years old",108743,60326,48417
"Gangwon State","2020","70-79 Years old",61333,34030,27303
"Gangwon State","2020","80 years and over",26458,14222,12236
"Gangwon State","2020","dead",12839,10842,1997
"Gangwon State","2021","Total",473451,262062,211389
"Gangwon State","2021","Under 30 years",8322,4933,3389
"Gangwon State","2021","30-39 Years old",41452,24791,16661
"Gangwon State","2021","40-49 Years old",87150,48000,39150
"Gangwon State","2021","50-59 Years old",114899,60339,54560
"Gangwon State","2021","60-69 Years old",119415,65291,54124
"Gangwon State","2021","70-79 Years old",61227,33410,27817
"Gangwon State","2021","80 years and over",28982,15351,13631
"Gangwon State","2021","dead",12004,9947,2057
"Gangwon State","2022","Total",484622,266033,218589
"Gangwon State","2022","Under 30 years",8125,4773,3352
"Gangwon State","2022","30-39 Years old",40067,23992,16075
"Gangwon State","2022","40-49 Years old",86981,47981,39000
"Gangwon State","2022","50-59 Years old",116590,60856,55734
"Gangwon State","2022","60-69 Years old",124057,66767,57290
"Gangwon State","2022","70-79 Years old",64660,35114,29546
"Gangwon State","2022","80 years and over",31959,16564,15395
"Gangwon State","2022","dead",12183,9986,2197
"Gangwon State","2023","Total",492745,268674,224071
"Gangwon State","2023","Under 30 years",7320,4228,3092
"Gangwon State","2023","30-39 Years old",38142,22966,15176
"Gangwon State","2023","40-49 Years old",85150,47225,37925
"Gangwon State","2023","50-59 Years old",117956,61466,56490
"Gangwon State","2023","60-69 Years old",130108,69250,60858
"Gangwon State","2023","70-79 Years old",67344,36155,31189
"Gangwon State","2023","80 years and over",34456,17461,16995
"Gangwon State","2023","dead",12269,9923,2346
"Chungcheongbuk-do","2012","Total",385708,237524,148184
"Chungcheongbuk-do","2012","Under 30 years",9237,5446,3791
"Chungcheongbuk-do","2012","30-39 Years old",59838,35564,24274
"Chungcheongbuk-do","2012","40-49 Years old",93530,54934,38596
"Chungcheongbuk-do","2012","50-59 Years old",98469,60011,38458
"Chungcheongbuk-do","2012","60-69 Years old",60288,37660,22628
"Chungcheongbuk-do","2012","70-79 Years old",42312,26690,15622
"Chungcheongbuk-do","2012","80 years and over",9693,6185,3508
"Chungcheongbuk-do","2012","dead",12341,11034,1307
"Chungcheongbuk-do","2013","Total",401423,244921,156502
"Chungcheongbuk-do","2013","Under 30 years",8394,4969,3425
"Chungcheongbuk-do","2013","30-39 Years old",59327,35361,23966
"Chungcheongbuk-do","2013","40-49 Years old",96704,55759,40945
"Chungcheongbuk-do","2013","50-59 Years old",103009,61856,41153
"Chungcheongbuk-do","2013","60-69 Years old",63556,39254,24302
"Chungcheongbuk-do","2013","70-79 Years old",45671,28516,17155
"Chungcheongbuk-do","2013","80 years and over",11346,7187,4159
"Chungcheongbuk-do","2013","dead",13416,12019,1397
"Chungcheongbuk-do","2014","Total",406834,245502,161332
"Chungcheongbuk-do","2014","Under 30 years",8117,4844,3273
"Chungcheongbuk-do","2014","30-39 Years old",57621,34581,23040
"Chungcheongbuk-do","2014","40-49 Years old",98636,56192,42444
"Chungcheongbuk-do","2014","50-59 Years old",103913,61213,42700
"Chungcheongbuk-do","2014","60-69 Years old",66236,40330,25906
"Chungcheongbuk-do","2014","70-79 Years old",45956,28094,17862
"Chungcheongbuk-do","2014","80 years and over",11274,6675,4599
"Chungcheongbuk-do","2014","dead",15081,13573,1508
"Chungcheongbuk-do","2015","Total",414536,246527,168009
"Chungcheongbuk-do","2015","Under 30 years",9364,5507,3857
"Chungcheongbuk-do","2015","30-39 Years old",57414,34702,22712
"Chungcheongbuk-do","2015","40-49 Years old",99532,56014,43518
"Chungcheongbuk-do","2015","50-59 Years old",106136,61083,45053
"Chungcheongbuk-do","2015","60-69 Years old",69810,41654,28156
"Chungcheongbuk-do","2015","70-79 Years old",45046,27066,17980
"Chungcheongbuk-do","2015","80 years and over",12453,7247,5206
"Chungcheongbuk-do","2015","dead",14781,13254,1527
"Chungcheongbuk-do","2016","Total",426272,251799,174473
"Chungcheongbuk-do","2016","Under 30 years",8154,4809,3345
"Chungcheongbuk-do","2016","30-39 Years old",55380,33740,21640
"Chungcheongbuk-do","2016","40-49 Years old",99235,55320,43915
"Chungcheongbuk-do","2016","50-59 Years old",109299,61925,47374
"Chungcheongbuk-do","2016","60-69 Years old",76707,45297,31410
"Chungcheongbuk-do","2016","70-79 Years old",46837,27909,18928
"Chungcheongbuk-do","2016","80 years and over",14734,8541,6193
"Chungcheongbuk-do","2016","dead",15926,14258,1668
"Chungcheongbuk-do","2017","Total",441796,259881,181915
"Chungcheongbuk-do","2017","Under 30 years",7929,4728,3201
"Chungcheongbuk-do","2017","30-39 Years old",53726,32964,20762
"Chungcheongbuk-do","2017","40-49 Years old",99499,55534,43965
"Chungcheongbuk-do","2017","50-59 Years old",112553,62952,49601
"Chungcheongbuk-do","2017","60-69 Years old",83781,49138,34643
"Chungcheongbuk-do","2017","70-79 Years old",50509,29912,20597
"Chungcheongbuk-do","2017","80 years and over",17219,9903,7316
"Chungcheongbuk-do","2017","dead",16580,14750,1830
"Chungcheongbuk-do","2018","Total",453048,264455,188593
"Chungcheongbuk-do","2018","Under 30 years",8448,5033,3415
"Chungcheongbuk-do","2018","30-39 Years old",53446,33129,20317
"Chungcheongbuk-do","2018","40-49 Years old",98949,55472,43477
"Chungcheongbuk-do","2018","50-59 Years old",115498,63364,52134
"Chungcheongbuk-do","2018","60-69 Years old",89050,51424,37626
"Chungcheongbuk-do","2018","70-79 Years old",52064,30552,21512
"Chungcheongbuk-do","2018","80 years and over",19846,11630,8216
"Chungcheongbuk-do","2018","dead",15747,13851,1896
"Chungcheongbuk-do","2019","Total",469366,272467,196899
"Chungcheongbuk-do","2019","Under 30 years",8596,5141,3455
"Chungcheongbuk-do","2019","30-39 Years old",53270,33178,20092
"Chungcheongbuk-do","2019","40-49 Years old",99145,55953,43192
"Chungcheongbuk-do","2019","50-59 Years old",120105,64977,55128
"Chungcheongbuk-do","2019","60-69 Years old",95320,54338,40982
"Chungcheongbuk-do","2019","70-79 Years old",54017,31371,22646
"Chungcheongbuk-do","2019","80 years and over",22319,12950,9369
"Chungcheongbuk-do","2019","dead",16594,14559,2035
"Chungcheongbuk-do","2020","Total",482771,277872,204899
"Chungcheongbuk-do","2020","Under 30 years",9023,5390,3633
"Chungcheongbuk-do","2020","30-39 Years old",52281,32620,19661
"Chungcheongbuk-do","2020","40-49 Years old",99825,56455,43370
"Chungcheongbuk-do","2020","50-59 Years old",121707,65266,56441
"Chungcheongbuk-do","2020","60-69 Years old",103199,57780,45419
"Chungcheongbuk-do","2020","70-79 Years old",55469,31745,23724
"Chungcheongbuk-do","2020","80 years and over",24319,13815,10504
"Chungcheongbuk-do","2020","dead",16948,14801,2147
"Chungcheongbuk-do","2021","Total",493366,281033,212333
"Chungcheongbuk-do","2021","Under 30 years",9427,5566,3861
"Chungcheongbuk-do","2021","30-39 Years old",50632,31642,18990
"Chungcheongbuk-do","2021","40-49 Years old",98494,55985,42509
"Chungcheongbuk-do","2021","50-59 Years old",121898,64540,57358
"Chungcheongbuk-do","2021","60-69 Years old",113736,62734,51002
"Chungcheongbuk-do","2021","70-79 Years old",56323,31675,24648
"Chungcheongbuk-do","2021","80 years and over",26626,14796,11830
"Chungcheongbuk-do","2021","dead",16230,14095,2135
"Chungcheongbuk-do","2022","Total",499702,283001,216701
"Chungcheongbuk-do","2022","Under 30 years",8834,5158,3676
"Chungcheongbuk-do","2022","30-39 Years old",47183,29741,17442
"Chungcheongbuk-do","2022","40-49 Years old",98013,56063,41950
"Chungcheongbuk-do","2022","50-59 Years old",122193,64349,57844
"Chungcheongbuk-do","2022","60-69 Years old",118519,64776,53743
"Chungcheongbuk-do","2022","70-79 Years old",59342,32952,26390
"Chungcheongbuk-do","2022","80 years and over",29426,16047,13379
"Chungcheongbuk-do","2022","dead",16192,13915,2277
"Chungcheongbuk-do","2023","Total",511649,288100,223549
"Chungcheongbuk-do","2023","Under 30 years",8448,4921,3527
"Chungcheongbuk-do","2023","30-39 Years old",46355,29397,16958
"Chungcheongbuk-do","2023","40-49 Years old",97472,56268,41204
"Chungcheongbuk-do","2023","50-59 Years old",125774,65878,59896
"Chungcheongbuk-do","2023","60-69 Years old",123909,66990,56919
"Chungcheongbuk-do","2023","70-79 Years old",62231,34183,28048
"Chungcheongbuk-do","2023","80 years and over",31366,16729,14637
"Chungcheongbuk-do","2023","dead",16094,13734,2360
"Chungcheongnam-do","2012","Total",476502,299319,177183
"Chungcheongnam-do","2012","Under 30 years",11168,6249,4919
"Chungcheongnam-do","2012","30-39 Years old",74652,45989,28663
"Chungcheongnam-do","2012","40-49 Years old",109195,65560,43635
"Chungcheongnam-do","2012","50-59 Years old",110639,68177,42462
"Chungcheongnam-do","2012","60-69 Years old",76934,48831,28103
"Chungcheongnam-do","2012","70-79 Years old",58976,37285,21691
"Chungcheongnam-do","2012","80 years and over",15490,9791,5699
"Chungcheongnam-do","2012","dead",19448,17437,2011
"Chungcheongnam-do","2013","Total",498651,312012,186639
"Chungcheongnam-do","2013","Under 30 years",10145,5727,4418
"Chungcheongnam-do","2013","30-39 Years old",73508,45464,28044
"Chungcheongnam-do","2013","40-49 Years old",112831,67108,45723
"Chungcheongnam-do","2013","50-59 Years old",117645,71783,45862
"Chungcheongnam-do","2013","60-69 Years old",80990,51050,29940
"Chungcheongnam-do","2013","70-79 Years old",63375,39789,23586
"Chungcheongnam-do","2013","80 years and over",18701,11844,6857
"Chungcheongnam-do","2013","dead",21456,19247,2209
"Chungcheongnam-do","2014","Total",520719,322316,198403
"Chungcheongnam-do","2014","Under 30 years",11085,6147,4938
"Chungcheongnam-do","2014","30-39 Years old",77567,48543,29024
"Chungcheongnam-do","2014","40-49 Years old",118609,69807,48802
"Chungcheongnam-do","2014","50-59 Years old",120549,72131,48418
"Chungcheongnam-do","2014","60-69 Years old",84480,52511,31969
"Chungcheongnam-do","2014","70-79 Years old",64944,39984,24960
"Chungcheongnam-do","2014","80 years and over",19922,12094,7828
"Chungcheongnam-do","2014","dead",23563,21099,2464
"Chungcheongnam-do","2015","Total",533423,325831,207592
"Chungcheongnam-do","2015","Under 30 years",13150,7263,5887
"Chungcheongnam-do","2015","30-39 Years old",78218,49313,28905
"Chungcheongnam-do","2015","40-49 Years old",121537,70906,50631
"Chungcheongnam-do","2015","50-59 Years old",123915,72736,51179
"Chungcheongnam-do","2015","60-69 Years old",89743,54816,34927
"Chungcheongnam-do","2015","70-79 Years old",62858,37999,24859
"Chungcheongnam-do","2015","80 years and over",21339,12619,8720
"Chungcheongnam-do","2015","dead",22663,20179,2484
"Chungcheongnam-do","2016","Total",555471,337002,218469
"Chungcheongnam-do","2016","Under 30 years",12596,6995,5601
"Chungcheongnam-do","2016","30-39 Years old",81183,51656,29527
"Chungcheongnam-do","2016","40-49 Years old",125669,72959,52710
"Chungcheongnam-do","2016","50-59 Years old",127612,73452,54160
"Chungcheongnam-do","2016","60-69 Years old",96867,58316,38551
"Chungcheongnam-do","2016","70-79 Years old",63410,38078,25332
"Chungcheongnam-do","2016","80 years and over",24300,14325,9975
"Chungcheongnam-do","2016","dead",23834,21221,2613
"Chungcheongnam-do","2017","Total",583830,353700,230130
"Chungcheongnam-do","2017","Under 30 years",12211,6908,5303
"Chungcheongnam-do","2017","30-39 Years old",81758,52178,29580
"Chungcheongnam-do","2017","40-49 Years old",129937,75622,54315
"Chungcheongnam-do","2017","50-59 Years old",133135,75901,57234
"Chungcheongnam-do","2017","60-69 Years old",104125,62414,41711
"Chungcheongnam-do","2017","70-79 Years old",69053,41756,27297
"Chungcheongnam-do","2017","80 years and over",28819,16934,11885
"Chungcheongnam-do","2017","dead",24792,21987,2805
"Chungcheongnam-do","2018","Total",604516,362834,241682
"Chungcheongnam-do","2018","Under 30 years",12327,7030,5297
"Chungcheongnam-do","2018","30-39 Years old",82991,53006,29985
"Chungcheongnam-do","2018","40-49 Years old",132395,77372,55023
"Chungcheongnam-do","2018","50-59 Years old",139334,78028,61306
"Chungcheongnam-do","2018","60-69 Years old",109384,64395,44989
"Chungcheongnam-do","2018","70-79 Years old",71518,42822,28696
"Chungcheongnam-do","2018","80 years and over",32606,19168,13438
"Chungcheongnam-do","2018","dead",23961,21013,2948
"Chungcheongnam-do","2019","Total",620151,369603,250548
"Chungcheongnam-do","2019","Under 30 years",11941,6776,5165
"Chungcheongnam-do","2019","30-39 Years old",81142,51879,29263
"Chungcheongnam-do","2019","40-49 Years old",134434,79089,55345
"Chungcheongnam-do","2019","50-59 Years old",144477,80032,64445
"Chungcheongnam-do","2019","60-69 Years old",114915,66495,48420
"Chungcheongnam-do","2019","70-79 Years old",73926,43909,30017
"Chungcheongnam-do","2019","80 years and over",35399,20503,14896
"Chungcheongnam-do","2019","dead",23917,20920,2997
"Chungcheongnam-do","2020","Total",634615,375441,259174
"Chungcheongnam-do","2020","Under 30 years",11804,6651,5153
"Chungcheongnam-do","2020","30-39 Years old",76220,48674,27546
"Chungcheongnam-do","2020","40-49 Years old",136126,80608,55518
"Chungcheongnam-do","2020","50-59 Years old",146755,80774,65981
"Chungcheongnam-do","2020","60-69 Years old",124144,70659,53485
"Chungcheongnam-do","2020","70-79 Years old",77481,45595,31886
"Chungcheongnam-do","2020","80 years and over",38008,21576,16432
"Chungcheongnam-do","2020","dead",24077,20904,3173
"Chungcheongnam-do","2021","Total",646326,379276,267050
"Chungcheongnam-do","2021","Under 30 years",12227,6886,5341
"Chungcheongnam-do","2021","30-39 Years old",71449,45440,26009
"Chungcheongnam-do","2021","40-49 Years old",135863,80955,54908
"Chungcheongnam-do","2021","50-59 Years old",148831,81157,67674
"Chungcheongnam-do","2021","60-69 Years old",135131,75702,59429
"Chungcheongnam-do","2021","70-79 Years old",78814,45860,32954
"Chungcheongnam-do","2021","80 years and over",39809,22333,17476
"Chungcheongnam-do","2021","dead",24202,20943,3259
"Chungcheongnam-do","2022","Total",654084,380654,273430
"Chungcheongnam-do","2022","Under 30 years",11383,6418,4965
"Chungcheongnam-do","2022","30-39 Years old",66061,41521,24540
"Chungcheongnam-do","2022","40-49 Years old",136839,81983,54856
"Chungcheongnam-do","2022","50-59 Years old",151587,82299,69288
"Chungcheongnam-do","2022","60-69 Years old",141276,77937,63339
"Chungcheongnam-do","2022","70-79 Years old",79965,45912,34053
"Chungcheongnam-do","2022","80 years and over",42304,23343,18961
"Chungcheongnam-do","2022","dead",24669,21241,3428
"Chungcheongnam-do","2023","Total",672089,388025,284064
"Chungcheongnam-do","2023","Under 30 years",10598,6042,4556
"Chungcheongnam-do","2023","30-39 Years old",63598,39664,23934
"Chungcheongnam-do","2023","40-49 Years old",137452,82883,54569
"Chungcheongnam-do","2023","50-59 Years old",157558,85237,72321
"Chungcheongnam-do","2023","60-69 Years old",149798,81575,68223
"Chungcheongnam-do","2023","70-79 Years old",83290,47166,36124
"Chungcheongnam-do","2023","80 years and over",44704,24013,20691
"Chungcheongnam-do","2023","dead",25091,21445,3646
"Jeollabuk-do","2012","Total",464225,277419,186806
"Jeollabuk-do","2012","Under 30 years",10317,6060,4257
"Jeollabuk-do","2012","30-39 Years old",62149,35732,26417
"Jeollabuk-do","2012","40-49 Years old",102430,56888,45542
"Jeollabuk-do","2012","50-59 Years old",108315,62900,45415
"Jeollabuk-do","2012","60-69 Years old",81598,50001,31597
"Jeollabuk-do","2012","70-79 Years old",60397,36212,24185
"Jeollabuk-do","2012","80 years and over",16327,9826,6501
"Jeollabuk-do","2012","dead",22692,19800,2892
"Jeollabuk-do","2013","Total",483582,286816,196766
"Jeollabuk-do","2013","Under 30 years",9306,5482,3824
"Jeollabuk-do","2013","30-39 Years old",60409,35106,25303
"Jeollabuk-do","2013","40-49 Years old",105950,58324,47626
"Jeollabuk-do","2013","50-59 Years old",114456,65382,49074
"Jeollabuk-do","2013","60-69 Years old",85266,51678,33588
"Jeollabuk-do","2013","70-79 Years old",64973,38587,26386
"Jeollabuk-do","2013","80 years and over",19193,11306,7887
"Jeollabuk-do","2013","dead",24029,20951,3078
"Jeollabuk-do","2014","Total",488326,286915,201411
"Jeollabuk-do","2014","Under 30 years",8618,5070,3548
"Jeollabuk-do","2014","30-39 Years old",57620,33755,23865
"Jeollabuk-do","2014","40-49 Years old",108582,59356,49226
"Jeollabuk-do","2014","50-59 Years old",115409,64774,50635
"Jeollabuk-do","2014","60-69 Years old",87724,52467,35257
"Jeollabuk-do","2014","70-79 Years old",65156,38236,26920
"Jeollabuk-do","2014","80 years and over",19717,11019,8698
"Jeollabuk-do","2014","dead",25500,22238,3262
"Jeollabuk-do","2015","Total",500617,289859,210758
"Jeollabuk-do","2015","Under 30 years",10981,6319,4662
"Jeollabuk-do","2015","30-39 Years old",58855,34643,24212
"Jeollabuk-do","2015","40-49 Years old",111042,60140,50902
"Jeollabuk-do","2015","50-59 Years old",117697,64527,53170
"Jeollabuk-do","2015","60-69 Years old",92572,54292,38280
"Jeollabuk-do","2015","70-79 Years old",63522,36787,26735
"Jeollabuk-do","2015","80 years and over",21145,11607,9538
"Jeollabuk-do","2015","dead",24803,21544,3259
"Jeollabuk-do","2016","Total",503407,290112,213295
"Jeollabuk-do","2016","Under 30 years",9018,5252,3766
"Jeollabuk-do","2016","30-39 Years old",56093,33360,22733
"Jeollabuk-do","2016","40-49 Years old",109665,59190,50475
"Jeollabuk-do","2016","50-59 Years old",118757,64200,54557
"Jeollabuk-do","2016","60-69 Years old",96008,55484,40524
"Jeollabuk-do","2016","70-79 Years old",64299,37151,27148
"Jeollabuk-do","2016","80 years and over",23476,12840,10636
"Jeollabuk-do","2016","dead",26091,22635,3456
"Jeollabuk-do","2017","Total",519633,298674,220959
"Jeollabuk-do","2017","Under 30 years",8694,5074,3620
"Jeollabuk-do","2017","30-39 Years old",53677,32256,21421
"Jeollabuk-do","2017","40-49 Years old",109347,59322,50025
"Jeollabuk-do","2017","50-59 Years old",121451,64950,56501
"Jeollabuk-do","2017","60-69 Years old",100860,57802,43058
"Jeollabuk-do","2017","70-79 Years old",70958,40943,30015
"Jeollabuk-do","2017","80 years and over",27654,15114,12540
"Jeollabuk-do","2017","dead",26992,23213,3779
"Jeollabuk-do","2018","Total",529293,301871,227422
"Jeollabuk-do","2018","Under 30 years",8626,4974,3652
"Jeollabuk-do","2018","30-39 Years old",52814,31978,20836
"Jeollabuk-do","2018","40-49 Years old",107980,58686,49294
"Jeollabuk-do","2018","50-59 Years old",125021,65982,59039
"Jeollabuk-do","2018","60-69 Years old",103886,58651,45235
"Jeollabuk-do","2018","70-79 Years old",73373,41924,31449
"Jeollabuk-do","2018","80 years and over",31180,17192,13988
"Jeollabuk-do","2018","dead",26413,22484,3929
"Jeollabuk-do","2019","Total",536922,303896,233026
"Jeollabuk-do","2019","Under 30 years",8246,4737,3509
"Jeollabuk-do","2019","30-39 Years old",50317,30487,19830
"Jeollabuk-do","2019","40-49 Years old",106716,58298,48418
"Jeollabuk-do","2019","50-59 Years old",127178,66537,60641
"Jeollabuk-do","2019","60-69 Years old",108256,60185,48071
"Jeollabuk-do","2019","70-79 Years old",75294,42440,32854
"Jeollabuk-do","2019","80 years and over",34076,18515,15561
"Jeollabuk-do","2019","dead",26839,22697,4142
"Jeollabuk-do","2020","Total",548245,307511,240734
"Jeollabuk-do","2020","Under 30 years",8286,4710,3576
"Jeollabuk-do","2020","30-39 Years old",48116,28996,19120
"Jeollabuk-do","2020","40-49 Years old",106848,58575,48273
"Jeollabuk-do","2020","50-59 Years old",127871,66498,61373
"Jeollabuk-do","2020","60-69 Years old",114726,62543,52183
"Jeollabuk-do","2020","70-79 Years old",78863,44061,34802
"Jeollabuk-do","2020","80 years and over",36656,19543,17113
"Jeollabuk-do","2020","dead",26879,22585,4294
"Jeollabuk-do","2021","Total",557185,308512,248673
"Jeollabuk-do","2021","Under 30 years",8900,5048,3852
"Jeollabuk-do","2021","30-39 Years old",46259,27677,18582
"Jeollabuk-do","2021","40-49 Years old",104716,57684,47032
"Jeollabuk-do","2021","50-59 Years old",130307,67123,63184
"Jeollabuk-do","2021","60-69 Years old",121920,64959,56961
"Jeollabuk-do","2021","70-79 Years old",80590,44313,36277
"Jeollabuk-do","2021","80 years and over",39022,20487,18535
"Jeollabuk-do","2021","dead",25471,21221,4250
"Jeollabuk-do","2022","Total",555750,305758,249992
"Jeollabuk-do","2022","Under 30 years",8074,4661,3413
"Jeollabuk-do","2022","30-39 Years old",41578,24832,16746
"Jeollabuk-do","2022","40-49 Years old",101887,56397,45490
"Jeollabuk-do","2022","50-59 Years old",131176,67344,63832
"Jeollabuk-do","2022","60-69 Years old",125213,65817,59396
"Jeollabuk-do","2022","70-79 Years old",79341,43222,36119
"Jeollabuk-do","2022","80 years and over",42482,22038,20444
"Jeollabuk-do","2022","dead",25999,21447,4552
"Jeollabuk-do","2023","Total",566305,308795,257510
"Jeollabuk-do","2023","Under 30 years",7956,4584,3372
"Jeollabuk-do","2023","30-39 Years old",40265,23892,16373
"Jeollabuk-do","2023","40-49 Years old",99745,55644,44101
"Jeollabuk-do","2023","50-59 Years old",134792,69048,65744
"Jeollabuk-do","2023","60-69 Years old",131490,68227,63263
"Jeollabuk-do","2023","70-79 Years old",81436,43674,37762
"Jeollabuk-do","2023","80 years and over",44864,22612,22252
"Jeollabuk-do","2023","dead",25757,21114,4643
"Jeollanam-do","2012","Total",485341,308167,177174
"Jeollanam-do","2012","Under 30 years",9548,5731,3817
"Jeollanam-do","2012","30-39 Years old",52460,30731,21729
"Jeollanam-do","2012","40-49 Years old",93942,55318,38624
"Jeollanam-do","2012","50-59 Years old",107666,66343,41323
"Jeollanam-do","2012","60-69 Years old",88642,57061,31581
"Jeollanam-do","2012","70-79 Years old",72195,44783,27412
"Jeollanam-do","2012","80 years and over",20513,12456,8057
"Jeollanam-do","2012","dead",40375,35744,4631
"Jeollanam-do","2013","Total",504612,318047,186565
"Jeollanam-do","2013","Under 30 years",8543,5088,3455
"Jeollanam-do","2013","30-39 Years old",51819,30651,21168
"Jeollanam-do","2013","40-49 Years old",95813,55519,40294
"Jeollanam-do","2013","50-59 Years old",113934,69159,44775
"Jeollanam-do","2013","60-69 Years old",91163,58157,33006
"Jeollanam-do","2013","70-79 Years old",77127,47572,29555
"Jeollanam-do","2013","80 years and over",23607,14145,9462
"Jeollanam-do","2013","dead",42606,37756,4850
"Jeollanam-do","2014","Total",502584,312050,190534
"Jeollanam-do","2014","Under 30 years",7775,4667,3108
"Jeollanam-do","2014","30-39 Years old",50582,29912,20670
"Jeollanam-do","2014","40-49 Years old",95070,54027,41043
"Jeollanam-do","2014","50-59 Years old",113180,66942,46238
"Jeollanam-do","2014","60-69 Years old",91230,57156,34074
"Jeollanam-do","2014","70-79 Years old",76396,46246,30150
"Jeollanam-do","2014","80 years and over",23060,12999,10061
"Jeollanam-do","2014","dead",45291,40101,5190
"Jeollanam-do","2015","Total",512148,313062,199086
"Jeollanam-do","2015","Under 30 years",11058,6366,4692
"Jeollanam-do","2015","30-39 Years old",52894,31520,21374
"Jeollanam-do","2015","40-49 Years old",97033,54575,42458
"Jeollanam-do","2015","50-59 Years old",115554,66769,48785
"Jeollanam-do","2015","60-69 Years old",93654,57670,35984
"Jeollanam-do","2015","70-79 Years old",73515,43761,29754
"Jeollanam-do","2015","80 years and over",24013,13228,10785
"Jeollanam-do","2015","dead",44427,39173,5254
"Jeollanam-do","2016","Total",518670,315245,203425
"Jeollanam-do","2016","Under 30 years",9068,5365,3703
"Jeollanam-do","2016","30-39 Years old",52110,31381,20729
"Jeollanam-do","2016","40-49 Years old",95544,53270,42274
"Jeollanam-do","2016","50-59 Years old",117981,67190,50791
"Jeollanam-do","2016","60-69 Years old",97239,59023,38216
"Jeollanam-do","2016","70-79 Years old",74589,44187,30402
"Jeollanam-do","2016","80 years and over",26171,14427,11744
"Jeollanam-do","2016","dead",45968,40402,5566
"Jeollanam-do","2017","Total",537573,326020,211553
"Jeollanam-do","2017","Under 30 years",8217,4900,3317
"Jeollanam-do","2017","30-39 Years old",50749,31154,19595
"Jeollanam-do","2017","40-49 Years old",95284,53181,42103
"Jeollanam-do","2017","50-59 Years old",120746,68503,52243
"Jeollanam-do","2017","60-69 Years old",102882,61899,40983
"Jeollanam-do","2017","70-79 Years old",81358,48064,33294
"Jeollanam-do","2017","80 years and over",30879,16841,14038
"Jeollanam-do","2017","dead",47458,41478,5980
"Jeollanam-do","2018","Total",546595,328904,217691
"Jeollanam-do","2018","Under 30 years",8876,5268,3608
"Jeollanam-do","2018","30-39 Years old",51177,31575,19602
"Jeollanam-do","2018","40-49 Years old",94824,53060,41764
"Jeollanam-do","2018","50-59 Years old",123374,68935,54439
"Jeollanam-do","2018","60-69 Years old",106012,62798,43214
"Jeollanam-do","2018","70-79 Years old",81978,48255,33723
"Jeollanam-do","2018","80 years and over",35179,19885,15294
"Jeollanam-do","2018","dead",45175,39128,6047
"Jeollanam-do","2019","Total",558332,333548,224784
"Jeollanam-do","2019","Under 30 years",8677,5160,3517
"Jeollanam-do","2019","30-39 Years old",49466,30835,18631
"Jeollanam-do","2019","40-49 Years old",94357,53033,41324
"Jeollanam-do","2019","50-59 Years old",125692,69608,56084
"Jeollanam-do","2019","60-69 Years old",111490,64874,46616
"Jeollanam-do","2019","70-79 Years old",84668,49460,35208
"Jeollanam-do","2019","80 years and over",38892,21675,17217
"Jeollanam-do","2019","dead",45090,38903,6187
"Jeollanam-do","2020","Total",574476,340186,234290
"Jeollanam-do","2020","Under 30 years",9071,5407,3664
"Jeollanam-do","2020","30-39 Years old",48782,30644,18138
"Jeollanam-do","2020","40-49 Years old",96939,54820,42119
"Jeollanam-do","2020","50-59 Years old",127256,69919,57337
"Jeollanam-do","2020","60-69 Years old",119242,68196,51046
"Jeollanam-do","2020","70-79 Years old",86739,50117,36622
"Jeollanam-do","2020","80 years and over",42274,23060,19214
"Jeollanam-do","2020","dead",44173,38023,6150
"Jeollanam-do","2021","Total",588595,344365,244230
"Jeollanam-do","2021","Under 30 years",9554,5654,3900
"Jeollanam-do","2021","30-39 Years old",48197,30103,18094
"Jeollanam-do","2021","40-49 Years old",97769,55386,42383
"Jeollanam-do","2021","50-59 Years old",130447,71216,59231
"Jeollanam-do","2021","60-69 Years old",127182,71290,55892
"Jeollanam-do","2021","70-79 Years old",87547,50075,37472
"Jeollanam-do","2021","80 years and over",45397,24355,21042
"Jeollanam-do","2021","dead",42502,36286,6216
"Jeollanam-do","2022","Total",593542,344876,248666
"Jeollanam-do","2022","Under 30 years",9164,5460,3704
"Jeollanam-do","2022","30-39 Years old",45240,28342,16898
"Jeollanam-do","2022","40-49 Years old",97255,55490,41765
"Jeollanam-do","2022","50-59 Years old",132266,71760,60506
"Jeollanam-do","2022","60-69 Years old",131961,73074,58887
"Jeollanam-do","2022","70-79 Years old",87070,49425,37645
"Jeollanam-do","2022","80 years and over",48403,25566,22837
"Jeollanam-do","2022","dead",42183,35759,6424
"Jeollanam-do","2023","Total",605006,348948,256058
"Jeollanam-do","2023","Under 30 years",8817,5190,3627
"Jeollanam-do","2023","30-39 Years old",43741,27448,16293
"Jeollanam-do","2023","40-49 Years old",96619,55766,40853
"Jeollanam-do","2023","50-59 Years old",134662,72748,61914
"Jeollanam-do","2023","60-69 Years old",139864,76726,63138
"Jeollanam-do","2023","70-79 Years old",89105,49974,39131
"Jeollanam-do","2023","80 years and over",51001,26368,24633
"Jeollanam-do","2023","dead",41197,34728,6469
"Gyeongsangbuk-do","2012","Total",696431,449409,247022
"Gyeongsangbuk-do","2012","Under 30 years",13710,7906,5804
"Gyeongsangbuk-do","2012","30-39 Years old",89291,54274,35017
"Gyeongsangbuk-do","2012","40-49 Years old",149496,92555,56941
"Gyeongsangbuk-do","2012","50-59 Years old",173222,110319,62903
"Gyeongsangbuk-do","2012","60-69 Years old",120113,77973,42140
"Gyeongsangbuk-do","2012","70-79 Years old",85609,54304,31305
"Gyeongsangbuk-do","2012","80 years and over",23096,14674,8422
"Gyeongsangbuk-do","2012","dead",41894,37404,4490
"Gyeongsangbuk-do","2013","Total",720722,461502,259220
"Gyeongsangbuk-do","2013","Under 30 years",12715,7446,5269
"Gyeongsangbuk-do","2013","30-39 Years old",87221,53174,34047
"Gyeongsangbuk-do","2013","40-49 Years old",150037,91079,58958
"Gyeongsangbuk-do","2013","50-59 Years old",179732,112676,67056
"Gyeongsangbuk-do","2013","60-69 Years old",126258,81328,44930
"Gyeongsangbuk-do","2013","70-79 Years old",92912,58549,34363
"Gyeongsangbuk-do","2013","80 years and over",26723,16956,9767
"Gyeongsangbuk-do","2013","dead",45124,40294,4830
"Gyeongsangbuk-do","2014","Total",720710,456203,264507
"Gyeongsangbuk-do","2014","Under 30 years",11945,7082,4863
"Gyeongsangbuk-do","2014","30-39 Years old",83613,51432,32181
"Gyeongsangbuk-do","2014","40-49 Years old",149182,88718,60464
"Gyeongsangbuk-do","2014","50-59 Years old",179135,109996,69139
"Gyeongsangbuk-do","2014","60-69 Years old",128938,81876,47062
"Gyeongsangbuk-do","2014","70-79 Years old",92421,57275,35146
"Gyeongsangbuk-do","2014","80 years and over",25676,15341,10335
"Gyeongsangbuk-do","2014","dead",49800,44483,5317
"Gyeongsangbuk-do","2015","Total",754879,470751,284128
"Gyeongsangbuk-do","2015","Under 30 years",15591,9005,6586
"Gyeongsangbuk-do","2015","30-39 Years old",86912,53910,33002
"Gyeongsangbuk-do","2015","40-49 Years old",154158,90595,63563
"Gyeongsangbuk-do","2015","50-59 Years old",185330,111685,73645
"Gyeongsangbuk-do","2015","60-69 Years old",140527,87955,52572
"Gyeongsangbuk-do","2015","70-79 Years old",93846,56944,36902
"Gyeongsangbuk-do","2015","80 years and over",29491,17065,12426
"Gyeongsangbuk-do","2015","dead",49024,43592,5432
"Gyeongsangbuk-do","2016","Total",770564,477110,293454
"Gyeongsangbuk-do","2016","Under 30 years",13667,7978,5689
"Gyeongsangbuk-do","2016","30-39 Years old",87788,54975,32813
"Gyeongsangbuk-do","2016","40-49 Years old",154273,89439,64834
"Gyeongsangbuk-do","2016","50-59 Years old",187750,111578,76172
"Gyeongsangbuk-do","2016","60-69 Years old",150332,92772,57560
"Gyeongsangbuk-do","2016","70-79 Years old",92825,55993,36832
"Gyeongsangbuk-do","2016","80 years and over",32650,18909,13741
"Gyeongsangbuk-do","2016","dead",51279,45466,5813
"Gyeongsangbuk-do","2017","Total",798792,491448,307344
"Gyeongsangbuk-do","2017","Under 30 years",13212,7857,5355
"Gyeongsangbuk-do","2017","30-39 Years old",87517,55131,32386
"Gyeongsangbuk-do","2017","40-49 Years old",156470,90228,66242
"Gyeongsangbuk-do","2017","50-59 Years old",191843,112337,79506
"Gyeongsangbuk-do","2017","60-69 Years old",160890,98521,62369
"Gyeongsangbuk-do","2017","70-79 Years old",99684,59923,39761
"Gyeongsangbuk-do","2017","80 years and over",36989,21378,15611
"Gyeongsangbuk-do","2017","dead",52187,46073,6114
"Gyeongsangbuk-do","2018","Total",818928,499090,319838
"Gyeongsangbuk-do","2018","Under 30 years",12907,7605,5302
"Gyeongsangbuk-do","2018","30-39 Years old",87238,55235,32003
"Gyeongsangbuk-do","2018","40-49 Years old",156337,89937,66400
"Gyeongsangbuk-do","2018","50-59 Years old",198051,113906,84145
"Gyeongsangbuk-do","2018","60-69 Years old",167607,101151,66456
"Gyeongsangbuk-do","2018","70-79 Years old",103977,62292,41685
"Gyeongsangbuk-do","2018","80 years and over",42983,25447,17536
"Gyeongsangbuk-do","2018","dead",49828,43517,6311
"Gyeongsangbuk-do","2019","Total",832387,503007,329380
"Gyeongsangbuk-do","2019","Under 30 years",12194,7121,5073
"Gyeongsangbuk-do","2019","30-39 Years old",83837,53285,30552
"Gyeongsangbuk-do","2019","40-49 Years old",155698,89642,66056
"Gyeongsangbuk-do","2019","50-59 Years old",201332,114360,86972
"Gyeongsangbuk-do","2019","60-69 Years old",175249,103972,71277
"Gyeongsangbuk-do","2019","70-79 Years old",107636,64131,43505
"Gyeongsangbuk-do","2019","80 years and over",46782,27259,19523
"Gyeongsangbuk-do","2019","dead",49659,43237,6422
"Gyeongsangbuk-do","2020","Total",847610,507692,339918
"Gyeongsangbuk-do","2020","Under 30 years",12250,7169,5081
"Gyeongsangbuk-do","2020","30-39 Years old",78950,50239,28711
"Gyeongsangbuk-do","2020","40-49 Years old",155532,89890,65642
"Gyeongsangbuk-do","2020","50-59 Years old",201438,113052,88386
"Gyeongsangbuk-do","2020","60-69 Years old",187697,109411,78286
"Gyeongsangbuk-do","2020","70-79 Years old",111252,65631,45621
"Gyeongsangbuk-do","2020","80 years and over",50460,28865,21595
"Gyeongsangbuk-do","2020","dead",50031,43435,6596
"Gyeongsangbuk-do","2021","Total",868281,513841,354440
"Gyeongsangbuk-do","2021","Under 30 years",13244,7723,5521
"Gyeongsangbuk-do","2021","30-39 Years old",76871,48773,28098
"Gyeongsangbuk-do","2021","40-49 Years old",156048,90423,65625
"Gyeongsangbuk-do","2021","50-59 Years old",202908,112187,90721
"Gyeongsangbuk-do","2021","60-69 Years old",202150,115871,86279
"Gyeongsangbuk-do","2021","70-79 Years old",114576,66827,47749
"Gyeongsangbuk-do","2021","80 years and over",54105,30296,23809
"Gyeongsangbuk-do","2021","dead",48379,41741,6638
"Gyeongsangbuk-do","2022","Total",873702,513569,360133
"Gyeongsangbuk-do","2022","Under 30 years",11804,6893,4911
"Gyeongsangbuk-do","2022","30-39 Years old",69455,44070,25385
"Gyeongsangbuk-do","2022","40-49 Years old",153371,89466,63905
"Gyeongsangbuk-do","2022","50-59 Years old",202739,111241,91498
"Gyeongsangbuk-do","2022","60-69 Years old",208992,118717,90275
"Gyeongsangbuk-do","2022","70-79 Years old",118799,68409,50390
"Gyeongsangbuk-do","2022","80 years and over",59041,32511,26530
"Gyeongsangbuk-do","2022","dead",49501,42262,7239
"Gyeongsangbuk-do","2023","Total",876159,510938,365221
"Gyeongsangbuk-do","2023","Under 30 years",11001,6425,4576
"Gyeongsangbuk-do","2023","30-39 Years old",64278,40901,23377
"Gyeongsangbuk-do","2023","40-49 Years old",149687,88011,61676
"Gyeongsangbuk-do","2023","50-59 Years old",202913,110411,92502
"Gyeongsangbuk-do","2023","60-69 Years old",214778,120564,94214
"Gyeongsangbuk-do","2023","70-79 Years old",122548,69907,52641
"Gyeongsangbuk-do","2023","80 years and over",62445,33456,28989
"Gyeongsangbuk-do","2023","dead",48509,41263,7246
"Gyeongsangnam-do","2012","Total",848060,512920,335140
"Gyeongsangnam-do","2012","Under 30 years",18896,11066,7830
"Gyeongsangnam-do","2012","30-39 Years old",135344,79989,55355
"Gyeongsangnam-do","2012","40-49 Years old",213184,123935,89249
"Gyeongsangnam-do","2012","50-59 Years old",213838,128576,85262
"Gyeongsangnam-do","2012","60-69 Years old",128329,78677,49652
"Gyeongsangnam-do","2012","70-79 Years old",83749,49205,34544
"Gyeongsangnam-do","2012","80 years and over",21883,12949,8934
"Gyeongsangnam-do","2012","dead",32837,28523,4314
"Gyeongsangnam-do","2013","Total",881925,528974,352951
"Gyeongsangnam-do","2013","Under 30 years",16998,10053,6945
"Gyeongsangnam-do","2013","30-39 Years old",133317,79469,53848
"Gyeongsangnam-do","2013","40-49 Years old",219704,125809,93895
"Gyeongsangnam-do","2013","50-59 Years old",225647,133656,91991
"Gyeongsangnam-do","2013","60-69 Years old",135875,82546,53329
"Gyeongsangnam-do","2013","70-79 Years old",90444,52508,37936
"Gyeongsangnam-do","2013","80 years and over",25102,14661,10441
"Gyeongsangnam-do","2013","dead",34838,30272,4566
"Gyeongsangnam-do","2014","Total",904834,537453,367381
"Gyeongsangnam-do","2014","Under 30 years",16488,9903,6585
"Gyeongsangnam-do","2014","30-39 Years old",135844,81772,54072
"Gyeongsangnam-do","2014","40-49 Years old",227190,128600,98590
"Gyeongsangnam-do","2014","50-59 Years old",229639,133264,96375
"Gyeongsangnam-do","2014","60-69 Years old",141508,85119,56389
"Gyeongsangnam-do","2014","70-79 Years old",91456,52365,39091
"Gyeongsangnam-do","2014","80 years and over",24778,13468,11310
"Gyeongsangnam-do","2014","dead",37931,32962,4969
"Gyeongsangnam-do","2015","Total",928149,544657,383492
"Gyeongsangnam-do","2015","Under 30 years",19304,11310,7994
"Gyeongsangnam-do","2015","30-39 Years old",137885,84179,53706
"Gyeongsangnam-do","2015","40-49 Years old",231111,129557,101554
"Gyeongsangnam-do","2015","50-59 Years old",234926,133733,101193
"Gyeongsangnam-do","2015","60-69 Years old",151735,89526,62209
"Gyeongsangnam-do","2015","70-79 Years old",90284,50934,39350
"Gyeongsangnam-do","2015","80 years and over",26509,14005,12504
"Gyeongsangnam-do","2015","dead",36395,31413,4982
"Gyeongsangnam-do","2016","Total",949755,554258,395497
"Gyeongsangnam-do","2016","Under 30 years",16858,9984,6874
"Gyeongsangnam-do","2016","30-39 Years old",134884,83192,51692
"Gyeongsangnam-do","2016","40-49 Years old",230962,128720,102242
"Gyeongsangnam-do","2016","50-59 Years old",241050,135344,105706
"Gyeongsangnam-do","2016","60-69 Years old",164403,95735,68668
"Gyeongsangnam-do","2016","70-79 Years old",92703,51990,40713
"Gyeongsangnam-do","2016","80 years and over",30042,15849,14193
"Gyeongsangnam-do","2016","dead",38853,33444,5409
"Gyeongsangnam-do","2017","Total",986620,573282,413338
"Gyeongsangnam-do","2017","Under 30 years",16077,9628,6449
"Gyeongsangnam-do","2017","30-39 Years old",133527,83036,50491
"Gyeongsangnam-do","2017","40-49 Years old",234114,130813,103301
"Gyeongsangnam-do","2017","50-59 Years old",249001,137953,111048
"Gyeongsangnam-do","2017","60-69 Years old",178191,102863,75328
"Gyeongsangnam-do","2017","70-79 Years old",100405,56224,44181
"Gyeongsangnam-do","2017","80 years and over",35180,18401,16779
"Gyeongsangnam-do","2017","dead",40125,34364,5761
"Gyeongsangnam-do","2018","Total",1009747,582339,427408
"Gyeongsangnam-do","2018","Under 30 years",15701,9277,6424
"Gyeongsangnam-do","2018","30-39 Years old",129950,80977,48973
"Gyeongsangnam-do","2018","40-49 Years old",233427,131029,102398
"Gyeongsangnam-do","2018","50-59 Years old",257087,140134,116953
"Gyeongsangnam-do","2018","60-69 Years old",188383,107458,80925
"Gyeongsangnam-do","2018","70-79 Years old",106093,59105,46988
"Gyeongsangnam-do","2018","80 years and over",40395,21593,18802
"Gyeongsangnam-do","2018","dead",38711,32766,5945
"Gyeongsangnam-do","2019","Total",1033218,592508,440710
"Gyeongsangnam-do","2019","Under 30 years",15250,9032,6218
"Gyeongsangnam-do","2019","30-39 Years old",123744,77194,46550
"Gyeongsangnam-do","2019","40-49 Years old",234304,132187,102117
"Gyeongsangnam-do","2019","50-59 Years old",264220,142670,121550
"Gyeongsangnam-do","2019","60-69 Years old",200513,112895,87618
"Gyeongsangnam-do","2019","70-79 Years old",111076,61627,49449
"Gyeongsangnam-do","2019","80 years and over",44503,23512,20991
"Gyeongsangnam-do","2019","dead",39608,33391,6217
"Gyeongsangnam-do","2020","Total",1055150,600581,454569
"Gyeongsangnam-do","2020","Under 30 years",15266,8939,6327
"Gyeongsangnam-do","2020","30-39 Years old",115864,72212,43652
"Gyeongsangnam-do","2020","40-49 Years old",235054,133357,101697
"Gyeongsangnam-do","2020","50-59 Years old",267339,142902,124437
"Gyeongsangnam-do","2020","60-69 Years old",217185,120542,96643
"Gyeongsangnam-do","2020","70-79 Years old",115836,63959,51877
"Gyeongsangnam-do","2020","80 years and over",48800,25310,23490
"Gyeongsangnam-do","2020","dead",39806,33360,6446
"Gyeongsangnam-do","2021","Total",1075438,607168,468270
"Gyeongsangnam-do","2021","Under 30 years",16153,9393,6760
"Gyeongsangnam-do","2021","30-39 Years old",110497,68645,41852
"Gyeongsangnam-do","2021","40-49 Years old",233272,133148,100124
"Gyeongsangnam-do","2021","50-59 Years old",269274,142705,126569
"Gyeongsangnam-do","2021","60-69 Years old",234455,128050,106405
"Gyeongsangnam-do","2021","70-79 Years old",119653,65441,54212
"Gyeongsangnam-do","2021","80 years and over",52855,27031,25824
"Gyeongsangnam-do","2021","dead",39279,32755,6524
"Gyeongsangnam-do","2022","Total",1080564,605677,474887
"Gyeongsangnam-do","2022","Under 30 years",14926,8586,6340
"Gyeongsangnam-do","2022","30-39 Years old",100303,62307,37996
"Gyeongsangnam-do","2022","40-49 Years old",230292,132194,98098
"Gyeongsangnam-do","2022","50-59 Years old",270660,142918,127742
"Gyeongsangnam-do","2022","60-69 Years old",244797,132204,112593
"Gyeongsangnam-do","2022","70-79 Years old",125164,68053,57111
"Gyeongsangnam-do","2022","80 years and over",57190,28763,28427
"Gyeongsangnam-do","2022","dead",37232,30652,6580
"Gyeongsangnam-do","2023","Total",1089324,606427,482897
"Gyeongsangnam-do","2023","Under 30 years",13250,7533,5717
"Gyeongsangnam-do","2023","30-39 Years old",90665,56124,34541
"Gyeongsangnam-do","2023","40-49 Years old",224184,129904,94280
"Gyeongsangnam-do","2023","50-59 Years old",275180,144589,130591
"Gyeongsangnam-do","2023","60-69 Years old",256638,137456,119182
"Gyeongsangnam-do","2023","70-79 Years old",131630,70888,60742
"Gyeongsangnam-do","2023","80 years and over",61224,30101,31123
"Gyeongsangnam-do","2023","dead",36553,29832,6721
"Jeju","2012","Total",131814,78567,53247
"Jeju","2012","Under 30 years",2542,1524,1018
"Jeju","2012","30-39 Years old",18011,10439,7572
"Jeju","2012","40-49 Years old",34121,19448,14673
"Jeju","2012","50-59 Years old",32092,19023,13069
"Jeju","2012","60-69 Years old",22352,13982,8370
"Jeju","2012","70-79 Years old",14457,8777,5680
"Jeju","2012","80 years and over",3337,1533,1804
"Jeju","2012","dead",4902,3841,1061
"Jeju","2013","Total",136441,80194,56247
"Jeju","2013","Under 30 years",2431,1426,1005
"Jeju","2013","30-39 Years old",18330,10557,7773
"Jeju","2013","40-49 Years old",35237,19670,15567
"Jeju","2013","50-59 Years old",34050,19842,14208
"Jeju","2013","60-69 Years old",22671,13917,8754
"Jeju","2013","70-79 Years old",14750,8930,5820
"Jeju","2013","80 years and over",3838,1814,2024
"Jeju","2013","dead",5134,4038,1096
"Jeju","2014","Total",143658,83707,59951
"Jeju","2014","Under 30 years",2547,1510,1037
"Jeju","2014","30-39 Years old",19035,10942,8093
"Jeju","2014","40-49 Years old",37211,20546,16665
"Jeju","2014","50-59 Years old",35971,20648,15323
"Jeju","2014","60-69 Years old",23536,14184,9352
"Jeju","2014","70-79 Years old",15621,9496,6125
"Jeju","2014","80 years and over",4250,2076,2174
"Jeju","2014","dead",5487,4305,1182
"Jeju","2015","Total",152997,88130,64867
"Jeju","2015","Under 30 years",3172,1877,1295
"Jeju","2015","30-39 Years old",19968,11515,8453
"Jeju","2015","40-49 Years old",39233,21533,17700
"Jeju","2015","50-59 Years old",37963,21351,16612
"Jeju","2015","60-69 Years old",25816,15224,10592
"Jeju","2015","70-79 Years old",16592,10006,6586
"Jeju","2015","80 years and over",4856,2396,2460
"Jeju","2015","dead",5397,4228,1169
"Jeju","2016","Total",160551,91407,69144
"Jeju","2016","Under 30 years",2988,1804,1184
"Jeju","2016","30-39 Years old",20823,11924,8899
"Jeju","2016","40-49 Years old",40713,22129,18584
"Jeju","2016","50-59 Years old",40381,22283,18098
"Jeju","2016","60-69 Years old",27690,16027,11663
"Jeju","2016","70-79 Years old",17249,10319,6930
"Jeju","2016","80 years and over",5350,2733,2617
"Jeju","2016","dead",5357,4188,1169
"Jeju","2017","Total",168750,95405,73345
"Jeju","2017","Under 30 years",3171,1911,1260
"Jeju","2017","30-39 Years old",21322,12256,9066
"Jeju","2017","40-49 Years old",42786,23096,19690
"Jeju","2017","50-59 Years old",42569,23165,19404
"Jeju","2017","60-69 Years old",29384,16874,12510
"Jeju","2017","70-79 Years old",18239,10902,7337
"Jeju","2017","80 years and over",5882,3015,2867
"Jeju","2017","dead",5397,4186,1211
"Jeju","2018","Total",175539,98204,77335
"Jeju","2018","Under 30 years",3479,2077,1402
"Jeju","2018","30-39 Years old",21792,12480,9312
"Jeju","2018","40-49 Years old",43737,23549,20188
"Jeju","2018","50-59 Years old",45063,24113,20950
"Jeju","2018","60-69 Years old",30814,17414,13400
"Jeju","2018","70-79 Years old",18986,11237,7749
"Jeju","2018","80 years and over",6569,3454,3115
"Jeju","2018","dead",5099,3880,1219
"Jeju","2019","Total",180441,100532,79909
"Jeju","2019","Under 30 years",3376,2026,1350
"Jeju","2019","30-39 Years old",20833,11966,8867
"Jeju","2019","40-49 Years old",44047,23769,20278
"Jeju","2019","50-59 Years old",46952,24929,22023
"Jeju","2019","60-69 Years old",33074,18445,14629
"Jeju","2019","70-79 Years old",19755,11625,8130
"Jeju","2019","80 years and over",7271,3875,3396
"Jeju","2019","dead",5133,3897,1236
"Jeju","2020","Total",185048,102309,82739
"Jeju","2020","Under 30 years",3512,2069,1443
"Jeju","2020","30-39 Years old",19949,11363,8586
"Jeju","2020","40-49 Years old",43908,23778,20130
"Jeju","2020","50-59 Years old",48557,25518,23039
"Jeju","2020","60-69 Years old",35713,19629,16084
"Jeju","2020","70-79 Years old",20309,11837,8472
"Jeju","2020","80 years and over",7958,4209,3749
"Jeju","2020","dead",5142,3906,1236
"Jeju","2021","Total",191211,104879,86332
"Jeju","2021","Under 30 years",3836,2222,1614
"Jeju","2021","30-39 Years old",19895,11297,8598
"Jeju","2021","40-49 Years old",44235,23945,20290
"Jeju","2021","50-59 Years old",50494,26341,24153
"Jeju","2021","60-69 Years old",38402,20741,17661
"Jeju","2021","70-79 Years old",20650,11928,8722
"Jeju","2021","80 years and over",8624,4554,4070
"Jeju","2021","dead",5075,3851,1224
"Jeju","2022","Total",196528,107195,89333
"Jeju","2022","Under 30 years",3758,2160,1598
"Jeju","2022","30-39 Years old",19228,10918,8310
"Jeju","2022","40-49 Years old",44848,24377,20471
"Jeju","2022","50-59 Years old",52295,27203,25092
"Jeju","2022","60-69 Years old",40636,21579,19057
"Jeju","2022","70-79 Years old",21281,12164,9117
"Jeju","2022","80 years and over",9405,4974,4431
"Jeju","2022","dead",5077,3820,1257
"Jeju","2023","Total",200438,108874,91564
"Jeju","2023","Under 30 years",3454,1992,1462
"Jeju","2023","30-39 Years old",18498,10487,8011
"Jeju","2023","40-49 Years old",44302,24232,20070
"Jeju","2023","50-59 Years old",53476,27656,25820
"Jeju","2023","60-69 Years old",43487,22995,20492
"Jeju","2023","70-79 Years old",22078,12428,9650
"Jeju","2023","80 years and over",10067,5266,4801
"Jeju","2023","dead",5076,3818,1258
